міндетінен	міндет:ROOT/і:MORPH/нен:MORPH
Платон	Платон:ROOT
ойланбастан	ой:ROOT/лан:MORPH/ба:MORPH/с:MORPH/тан:MORPH
араласқанда	ара:ROOT/лас:MORPH/қан:MORPH/да:MORPH
әлі	әлі:ROOT
философ	философ:ROOT
неге	неге:ROOT
тілі	тілі:ROOT
трагедияның	трагедия:ROOT/ның:MORPH
өзінен	өз:ROOT/і:MORPH/нен:MORPH
бірбірінен	бірбір:ROOT/і:MORPH/нен:MORPH
бұл	бұл:ROOT
бесінші	бес:ROOT/інші:MORPH
егжейтегжейлі	егжейтегжей:ROOT/лі:MORPH
жаңғырығы	жаңғырығ:ROOT/ы:MORPH
де	де:ROOT
Фрейд	Фрейд:ROOT
нобайын	нобай:ROOT/ы:MORPH/н:MORPH
жақсартатынын	жақсар:ROOT/т:MORPH/атын:MORPH/ы:MORPH/н:MORPH
терістеуінің	теріс:ROOT/те:MORPH/у:MORPH/і:MORPH/нің:MORPH
ұсақ	ұсақ:ROOT
мүмкін	мүмкін:ROOT
Платонның	Платон:ROOT/ның:MORPH
бай	бай:ROOT
қарсыластарымен	қарсы:ROOT/лас:MORPH/тар:MORPH/ы:MORPH/мен:MORPH
қызметіне	қызмет:ROOT/і:MORPH/не:MORPH
Эриксимах	Эриксимах:ROOT
айту	айт:ROOT/у:MORPH
бір	бір:ROOT
сезімдік	сез:ROOT/ім:MORPH/дік:MORPH
да	да:ROOT
Павсаний	Павсаний:ROOT
Эрос	Эрос:ROOT
ләззатқа	ләззат:ROOT/қа:MORPH
сол	сол:ROOT
шығармада	шығ:ROOT/ар:MORPH/ма:MORPH/да:MORPH
ойланбағанын	ойла:ROOT/н:MORPH/ба:MORPH/ған:MORPH/ы:MORPH/н:MORPH
Декартты	Декарт:ROOT/ты:MORPH
надандықты	надан:ROOT/дық:MORPH/ты:MORPH
француз	француз:ROOT
өз	өз:ROOT
түзетілмеген	түзе:ROOT/т:MORPH/іл:MORPH/ме:MORPH/ген:MORPH
шекарасын	шекара:ROOT/сы:MORPH/н:MORPH
суверен	суверен:ROOT
үшін	үшін:ROOT
тұра	тұр:ROOT/а:MORPH
Нағыз	Нағыз:ROOT
туындаса	туын:ROOT/да:MORPH/са:MORPH
жалғасын	жалғас:ROOT/ы:MORPH/н:MORPH
билікті	билік:ROOT/ті:MORPH
Пікір	Пікір:ROOT
сұңғыла	сұңғыла:ROOT
ұстазының	ұстаз:ROOT/ы:MORPH/ның:MORPH
адамның	адам:ROOT/ның:MORPH
Табиғат	Табиғат:ROOT
шындықтың	шын:ROOT/дық:MORPH/тың:MORPH
заманға	заман:ROOT/ға:MORPH
тұрғысынан	тұрғы:ROOT/сы:MORPH/нан:MORPH
өз	өз:ROOT
ділмәр	діл:ROOT/мәр:MORPH
Мұны	Мұ:ROOT/ны:MORPH
сол	сол:ROOT
күшейте	күш:ROOT/ей:MORPH/т:MORPH/е:MORPH
дәлелдерді	дәлел:ROOT/дер:MORPH/ді:MORPH
көбінесе	көб:ROOT/і:MORPH/не:MORPH/се:MORPH
дастарқан	дастарқан:ROOT
мазмұнына	мазмұн:ROOT/ы:MORPH/на:MORPH
өнерін	өнер:ROOT/ін:MORPH
шығармаларының	шығ:ROOT/ар:MORPH/ма:MORPH/лар:MORPH/ы:MORPH/ның:MORPH
сезім	сез:ROOT/ім:MORPH
Сондықтан	Сондық:ROOT/тан:MORPH
ізгілікті	із:ROOT/гілік:MORPH/ті:MORPH
Бірақ	Бірақ:ROOT
тіпті	тіпті:ROOT
қаза	қаза:ROOT
айтылады	айт:ROOT/ыл:MORPH/а:MORPH/ды:MORPH
құтқаратын	құтқар:ROOT/атын:MORPH
дұрыс	дұрыс:ROOT
бүр	бүр:ROOT
туындайтын	туын:ROOT/да:MORPH/йтын:MORPH
Карл	Карл:ROOT
Платон	Платон:ROOT
қызметке	қызмет:ROOT/ке:MORPH
мен	мен:ROOT
кез	кез:ROOT
үшін	үшін:ROOT
қарағанда	қара:ROOT/ған:MORPH/да:MORPH
кастрацияға	кастрация:ROOT/ға:MORPH
Мен	Мен:ROOT
ол	ол:ROOT
Неліктен	Нелік:ROOT/тен:MORPH
мемлекет	мемлекет:ROOT
еместігін	е:ROOT/мес:MORPH/ті:MORPH/гі:MORPH/н:MORPH
иелерінің	ие:ROOT/лер:MORPH/і:MORPH/нің:MORPH
бәрі	бәрі:ROOT
ал	ал:ROOT
осы	осы:ROOT
ішінде	іш:ROOT/і:MORPH/нде:MORPH
қалған	қал:ROOT/ған:MORPH
ойшылдың	ой:ROOT/шыл:MORPH/дың:MORPH
тұрғыдан	тұрғы:ROOT/дан:MORPH
айналған	айнал:ROOT/ған:MORPH
қатысты	қатыс:ROOT/ты:MORPH
тартымды	тарт:ROOT/ым:MORPH/ды:MORPH
қаланғанға	қала:ROOT/н:MORPH/ған:MORPH/ға:MORPH
мүмкіндік	мүмкін:ROOT/дік:MORPH
және	және:ROOT
еңбектерінің	еңбек:ROOT/тер:MORPH/і:MORPH/нің:MORPH
өзіне	өз:ROOT/і:MORPH/не:MORPH
немесе	немесе:ROOT
деп	де:ROOT/п:MORPH
баласы	баласы:ROOT
оны	о:ROOT/ны:MORPH
Білімге	Білім:ROOT/ге:MORPH
құштарлықпен	құштар:ROOT/лық:MORPH/пен:MORPH
әуелдегідей	әуел:ROOT/де:MORPH/гі:MORPH/дей:MORPH
анықтап	анықта:ROOT/п:MORPH
деген	де:ROOT/ген:MORPH
мазмұн	мазмұн:ROOT
шынайы	шынайы:ROOT
мәселе	мәселе:ROOT
бар	бар:ROOT
пен	пен:ROOT
өнерді	өнер:ROOT/ді:MORPH
қалай	қалай:ROOT
диалогтағы	диалог:ROOT/та:MORPH/ғы:MORPH
қоюдан	қо:ROOT/ю:MORPH/дан:MORPH
Астроном	Астроном:ROOT
ақиқат	ақиқат:ROOT
жалғаса	жалғас:ROOT/а:MORPH
картезиандық	картезиан:ROOT/дық:MORPH
мақсат	мақсат:ROOT
элементтер	элемент:ROOT/тер:MORPH
білімін	біл:ROOT/ім:MORPH/ін:MORPH
позитивті	позитив:ROOT/ті:MORPH
құмарлық	құмар:ROOT/лық:MORPH
ақылойдың	ақылой:ROOT/дың:MORPH
Сократтың	Сократ:ROOT/тың:MORPH
рақаттану	рақат:ROOT/тан:MORPH/у:MORPH
Локктың	Локк:ROOT/тың:MORPH
мәні	мән:ROOT/і:MORPH
Академияның	Академия:ROOT/ның:MORPH
және	және:ROOT
адамның	адам:ROOT/ның:MORPH
Бірінші	Бір:ROOT/інші:MORPH
келген	кел:ROOT/ген:MORPH
нәпсіні	нәпсі:ROOT/ні:MORPH
сұхбаттың	сұхбат:ROOT/тың:MORPH
шығармаларының	шығ:ROOT/ар:MORPH/ма:MORPH/лар:MORPH/ы:MORPH/ның:MORPH
таным	тан:ROOT/ым:MORPH
формасы	форма:ROOT/сы:MORPH
ол	ол:ROOT
махаббаттың	махаббат:ROOT/тың:MORPH
қарамастан	қара:ROOT/мас:MORPH/тан:MORPH
Олардың	О:ROOT/лар:MORPH/дың:MORPH
Шатле	Шатле:ROOT
жүрекке	жүрек:ROOT/ке:MORPH
даналықтың	дана:ROOT/лық:MORPH/тың:MORPH
махаббаты	махаббат:ROOT/ы:MORPH
болған	бол:ROOT/ған:MORPH
әпсанасы	әпсана:ROOT/сы:MORPH
сөз	сөз:ROOT
жағдайдың	жағдай:ROOT/дың:MORPH
болады	бол:ROOT/а:MORPH/ды:MORPH
ұмтылысқа	ұмтыл:ROOT/ыс:MORPH/қа:MORPH
өз	өз:ROOT
айналатын	айна:ROOT/л:MORPH/атын:MORPH
Десе	Де:ROOT/се:MORPH
кітаптың	кітап:ROOT/тың:MORPH
диалогтарынан	диалог:ROOT/тар:MORPH/ы:MORPH/нан:MORPH
Мемлекет	Мемлекет:ROOT
философтың	философ:ROOT/тың:MORPH
туралы	туралы:ROOT
деген	де:ROOT/ген:MORPH
тақуалыққа	тақуа:ROOT/лық:MORPH/қа:MORPH
мұндай	мұн:ROOT/дай:MORPH
өкілі	өкіл:ROOT/і:MORPH
жетілдіру	жет:ROOT/іл:MORPH/дір:MORPH/у:MORPH
қуатын	қуат:ROOT/ын:MORPH
деген	де:ROOT/ген:MORPH
бір	бір:ROOT
да	да:ROOT
жатқанын	жат:ROOT/қан:MORPH/ын:MORPH
Сократ	Сократ:ROOT
философиялық	философия:ROOT/лық:MORPH
Осы	Осы:ROOT
бірбірімен	бірбір:ROOT/і:MORPH/мен:MORPH
өрісіне	өріс:ROOT/і:MORPH/не:MORPH
үнсіз	үн:ROOT/сіз:MORPH
арасындағы	ара:ROOT/сы:MORPH/н:MORPH/да:MORPH/ғы:MORPH
екеуінің	еке:ROOT/у:MORPH/і:MORPH/нің:MORPH
және	және:ROOT
тән	тән:ROOT
толы	толы:ROOT
бола	бол:ROOT/а:MORPH
түсіндіруге	түсін:ROOT/дір:MORPH/у:MORPH/ге:MORPH
аяқталады	аяқтал:ROOT/а:MORPH/ды:MORPH
мүмкін	мүмкін:ROOT
болады	бол:ROOT/а:MORPH/ды:MORPH
тіліндегі	тіл:ROOT/і:MORPH/н:MORPH/де:MORPH/гі:MORPH
кейін	кейін:ROOT
Сократ	Сократ:ROOT
дүбірлі	дүбір:ROOT/лі:MORPH
жердегі	жер:ROOT/де:MORPH/гі:MORPH
сіз	сіз:ROOT
тығыз	тығыз:ROOT
Мемлекет	Мемлекет:ROOT
бе	бе:ROOT
қажетті	қажет:ROOT/ті:MORPH
ұмтылған	ұмтыл:ROOT/ған:MORPH
сезім	сез:ROOT/ім:MORPH
мәселелерге	мәселе:ROOT/лер:MORPH/ге:MORPH
мәселеге	мәселе:ROOT/ге:MORPH
ілімнің	ілім:ROOT/нің:MORPH
Сократ	Сократ:ROOT
да	да:ROOT
нақты	нақ:ROOT/ты:MORPH
екі	екі:ROOT
мемлекеттің	мемлекет:ROOT/тің:MORPH
санасы	сана:ROOT/сы:MORPH
туабітті	туабіт:ROOT/ті:MORPH
назарда	назар:ROOT/да:MORPH
мен	мен:ROOT
әпсананы	әпсана:ROOT/ны:MORPH
соқыр	соқыр:ROOT
сөйлеу	сөйле:ROOT/у:MORPH
философиялық	философия:ROOT/лық:MORPH
келтіруге	кел:ROOT/тір:MORPH/у:MORPH/ге:MORPH
әпсанасымен	әпсана:ROOT/сы:MORPH/мен:MORPH
ең	ең:ROOT
екені	е:ROOT/кен:MORPH/і:MORPH
қарастырып	қарас:ROOT/тыр:MORPH/ып:MORPH
тәуелділіктен	тәуел:ROOT/ді:MORPH/лік:MORPH/тен:MORPH
Оның	О:ROOT/ның:MORPH
алмады	ал:ROOT/ма:MORPH/ды:MORPH
көрсетеді	көр:ROOT/се:MORPH/т:MORPH/е:MORPH/ді:MORPH
құмарлығынан	құмар:ROOT/лығ:MORPH/ы:MORPH/нан:MORPH
Жұрттың	Жұрт:ROOT/тың:MORPH
Платонның	Платон:ROOT/ның:MORPH
Оған	О:ROOT/ған:MORPH
жүйелі	жүйе:ROOT/лі:MORPH
Құдайда	Құдай:ROOT/да:MORPH
мынадай	мына:ROOT/дай:MORPH
ойшылдары	ой:ROOT/шыл:MORPH/дар:MORPH/ы:MORPH
өздеріне	өздер:ROOT/і:MORPH/не:MORPH
қарымқатынас	қарымқатынас:ROOT
философиялық	философия:ROOT/лық:MORPH
Платон	Платон:ROOT
оған	о:ROOT/ған:MORPH
бас	бас:ROOT
сол	сол:ROOT
өмірге	өмір:ROOT/ге:MORPH
қараңыз	қара:ROOT/ңыз:MORPH
Симпозиумды	Симпозиум:ROOT/ды:MORPH
де	де:ROOT
қалаудан	қала:ROOT/у:MORPH/дан:MORPH
терең	терең:ROOT
комедиографты	комедиограф:ROOT/ты:MORPH
несімен	не:ROOT/сі:MORPH/мен:MORPH
олар	о:ROOT/лар:MORPH
шешендер	шешен:ROOT/дер:MORPH
өнерді	өнер:ROOT/ді:MORPH
қандай	қандай:ROOT
тұрғысынан	тұрғыс:ROOT/ы:MORPH/нан:MORPH
Сократ	Сократ:ROOT
ойдың	ой:ROOT/дың:MORPH
қозғалады	қозғ:ROOT/ал:MORPH/а:MORPH/ды:MORPH
керек	керек:ROOT
сұлу	сұлу:ROOT
айтқанда	айт:ROOT/қан:MORPH/да:MORPH
біз	біз:ROOT
айырмашылығы	айыр:ROOT/ма:MORPH/шылығ:MORPH/ы:MORPH
ықылық	ықылық:ROOT
жазасына	жаза:ROOT/сы:MORPH/на:MORPH
геометриялық	геометрия:ROOT/лық:MORPH
Экономист	Экономист:ROOT
екі	екі:ROOT
бас	бас:ROOT
Ол	Ол:ROOT
игілік	игі:ROOT/лік:MORPH
пен	пен:ROOT
ақылды	ақыл:ROOT/ды:MORPH
болған	бол:ROOT/ған:MORPH
поэтикалық	поэтика:ROOT/лық:MORPH
тұжырымдар	тұжырым:ROOT/дар:MORPH
Аристофанның	Аристофан:ROOT/ның:MORPH
да	да:ROOT
мүмкіндігінде	мүмкін:ROOT/діг:MORPH/і:MORPH/н:MORPH/де:MORPH
толғамға	тол:ROOT/ғам:MORPH/ға:MORPH
береді	бер:ROOT/е:MORPH/ді:MORPH
тәртіптің	тәртіп:ROOT/тің:MORPH
анық	анық:ROOT
тереңірек	терең:ROOT/ірек:MORPH
пен	пен:ROOT
мәдениет	мәдениет:ROOT
және	және:ROOT
бір	бір:ROOT
консервативті	консерватив:ROOT/ті:MORPH
махаббат	махаббат:ROOT
осындай	ос:ROOT/ындай:MORPH
жұмысы	жұмыс:ROOT/ы:MORPH
таластырушылар	талас:ROOT/тыр:MORPH/у:MORPH/шы:MORPH/лар:MORPH
алатынын	ал:ROOT/атын:MORPH/ын:MORPH
терминологияны	терминология:ROOT/ны:MORPH
ортадағы	орта:ROOT/да:MORPH/ғы:MORPH
орасан	орасан:ROOT
Эростың	Эрос:ROOT/тың:MORPH
қайтадан	қайта:ROOT/дан:MORPH
ІІ	ІІ:ROOT
жөн	жөн:ROOT
лайық	лайық:ROOT
ортасын	орта:ROOT/сы:MORPH/н:MORPH
Ол	Ол:ROOT
Марион	Марион:ROOT
тура	тура:ROOT
мадақ	мадақ:ROOT
даналық	дана:ROOT/лық:MORPH
екіншісі	ек:ROOT/інші:MORPH/сі:MORPH
маманның	маман:ROOT/ның:MORPH
сосын	сосын:ROOT
еншісіндегі	енші:ROOT/сі:MORPH/н:MORPH/де:MORPH/гі:MORPH
философ	философ:ROOT
стиль	стиль:ROOT
кеңейткісі	кеңей:ROOT/т:MORPH/кі:MORPH/сі:MORPH
өкілетті	өкілет:ROOT/ті:MORPH
Эриксимах	Эриксимах:ROOT
Шешен	Шешен:ROOT
секілді	секіл:ROOT/ді:MORPH
не	не:ROOT
оқырмандары	оқыр:ROOT/ман:MORPH/дар:MORPH/ы:MORPH
Толғаныстардың	Толғаныс:ROOT/тар:MORPH/дың:MORPH
Философия	Философия:ROOT
де	де:ROOT
Қоғамдық	Қоғам:ROOT/дық:MORPH
белгілі	белгі:ROOT/лі:MORPH
қолайсыз	қолай:ROOT/сыз:MORPH
шешенің	шеше:ROOT/нің:MORPH
көтерілу	көтер:ROOT/іл:MORPH/у:MORPH
картезиандықтардың	картезиан:ROOT/дық:MORPH/тар:MORPH/дың:MORPH
мазмұндамасы	мазмұн:ROOT/да:MORPH/ма:MORPH/сы:MORPH
ұстаным	ұстаным:ROOT
софистиканы	софистика:ROOT/ны:MORPH
Гоббс	Гоббс:ROOT
Сократқа	Сократ:ROOT/қа:MORPH
ешқандай	ешқандай:ROOT
ретінде	рет:ROOT/і:MORPH/н:MORPH/де:MORPH
өз	өз:ROOT
ешқандай	ешқандай:ROOT
адам	адам:ROOT
көреді	көр:ROOT/е:MORPH/ді:MORPH
ұлы	ұлы:ROOT
шашып	шаш:ROOT/ып:MORPH
шағында	шағ:ROOT/ы:MORPH/н:MORPH/да:MORPH
ұлына	ұл:ROOT/ы:MORPH/на:MORPH
қанша	қанша:ROOT
кейін	кейін:ROOT
енді	енді:ROOT
ұстанған	ұста:ROOT/н:MORPH/ған:MORPH
Шығармаларының	Шығ:ROOT/ар:MORPH/ма:MORPH/лар:MORPH/ы:MORPH/ның:MORPH
пікірлер	пікір:ROOT/лер:MORPH
әйел	әйел:ROOT
тобықтай	тобық:ROOT/тай:MORPH
атаса	ата:ROOT/са:MORPH
адасудың	адас:ROOT/у:MORPH/дың:MORPH
бірденбір	бір:ROOT/денбір:MORPH
әділдік	әділ:ROOT/дік:MORPH
мен	мен:ROOT
Сократтың	Сократ:ROOT/тың:MORPH
емес	е:ROOT/ме:MORPH/с:MORPH
негізінен	негіз:ROOT/і:MORPH/нен:MORPH
интуиция	интуиция:ROOT
ортаға	орта:ROOT/ға:MORPH
картезиандық	картезиан:ROOT/дық:MORPH
думан	думан:ROOT
тұтастығын	тұтас:ROOT/ты:MORPH/ғы:MORPH/н:MORPH
мен	мен:ROOT
сенімсіз	сен:ROOT/ім:MORPH/сіз:MORPH
аяғында	аяғ:ROOT/ы:MORPH/н:MORPH/да:MORPH
ғана	ғана:ROOT
мезі	мезі:ROOT
екенін	е:ROOT/кен:MORPH/і:MORPH/н:MORPH
көрінісі	көрініс:ROOT/і:MORPH
сезімталы	сез:ROOT/ім:MORPH/тал:MORPH/ы:MORPH
тартуы	тарт:ROOT/у:MORPH/ы:MORPH
бірдей	бір:ROOT/дей:MORPH
ақылдың	ақыл:ROOT/дың:MORPH
грек	грек:ROOT
жағдайларда	жағдай:ROOT/лар:MORPH/да:MORPH
жылдан	жыл:ROOT/дан:MORPH
ғана	ғана:ROOT
немесе	немесе:ROOT
РодисЛьюистің	РодисЛьюис:ROOT/тің:MORPH
ол	ол:ROOT
кез	кез:ROOT
үнемі	үнемі:ROOT
олар	о:ROOT/лар:MORPH
байланыс	байланыс:ROOT
алып	ал:ROOT/ып:MORPH
бой	бой:ROOT
ілгеріде	ілгері:ROOT/де:MORPH
туралы	туралы:ROOT
дәлелдерді	дәлел:ROOT/дер:MORPH/ді:MORPH
эмпирикалық	эмпирика:ROOT/лық:MORPH
Аристотель	Аристотель:ROOT
тазалығын	таза:ROOT/лығ:MORPH/ы:MORPH/н:MORPH
қарастырады	қарас:ROOT/тыр:MORPH/а:MORPH/ды:MORPH
анық	анық:ROOT
пен	пен:ROOT
арасында	ара:ROOT/сы:MORPH/н:MORPH/да:MORPH
Платон	Платон:ROOT
кейінірек	кейін:ROOT/ірек:MORPH
диалогтың	диалог:ROOT/тың:MORPH
еді	е:ROOT/ді:MORPH
көзқарас	көз:ROOT/қарас:MORPH
қарсы	қарсы:ROOT
ойынша	ой:ROOT/ы:MORPH/н:MORPH/ша:MORPH
әңгімесін	әңгіме:ROOT/сі:MORPH/н:MORPH
қарамақарсы	қара:ROOT/мақарсы:MORPH
сынды	сын:ROOT/ды:MORPH
қалдырған	қал:ROOT/дыр:MORPH/ған:MORPH
салыстырып	салыс:ROOT/тыр:MORPH/ып:MORPH
Ақиқатты	Ақиқат:ROOT/ты:MORPH
тіліндегі	тіл:ROOT/і:MORPH/н:MORPH/де:MORPH/гі:MORPH
сақ	сақ:ROOT
келген	кел:ROOT/ген:MORPH
көзқарас	көз:ROOT/қарас:MORPH
оның	о:ROOT/ның:MORPH
қалпында	қалпы:ROOT/н:MORPH/да:MORPH
ауысу	ауысу:ROOT
байланысатынын	байланыс:ROOT/атын:MORPH/ы:MORPH/н:MORPH
Платон	Платон:ROOT
пікірлерін	пікір:ROOT/лер:MORPH/і:MORPH/н:MORPH
түсуге	түс:ROOT/у:MORPH/ге:MORPH
деп	де:ROOT/п:MORPH
өйткені	өйткені:ROOT
ғана	ғана:ROOT
шынайы	шынайы:ROOT
Аристотель	Аристотель:ROOT
Диотима	Диотима:ROOT
мойындайды	мойында:ROOT/й:MORPH/ды:MORPH
аңқау	аңқау:ROOT
сызықтың	сызық:ROOT/тың:MORPH
тым	тым:ROOT
да	да:ROOT
мәрте	мәрте:ROOT
Агафон	Агафон:ROOT
іске	іс:ROOT/ке:MORPH
Ұстазынан	Ұстаз:ROOT/ы:MORPH/нан:MORPH
алмаймыз	ал:ROOT/ма:MORPH/й:MORPH/мыз:MORPH
мүлдем	мүлдем:ROOT
тартуға	тарт:ROOT/у:MORPH/ға:MORPH
Сөз	Сөз:ROOT
Алкивиад	Алкивиад:ROOT
белгілерін	белгі:ROOT/лер:MORPH/і:MORPH/н:MORPH
хатшысы	хат:ROOT/шы:MORPH/сы:MORPH
тілінде	тіл:ROOT/і:MORPH/н:MORPH/де:MORPH
Косттың	Кост:ROOT/тың:MORPH
Тәжірибелер	Тәжірибе:ROOT/лер:MORPH
бізге	біз:ROOT/ге:MORPH
асқақ	асқақ:ROOT
құлақ	құлақ:ROOT
жазасына	жаза:ROOT/сы:MORPH/на:MORPH
ал	ал:ROOT
білімнің	біл:ROOT/ім:MORPH/нің:MORPH
жоғары	жоғары:ROOT
мақсаты	мақсат:ROOT/ы:MORPH
Аристотель	Аристотель:ROOT
болғанымен	бол:ROOT/ған:MORPH/ы:MORPH/мен:MORPH
алынған	ал:ROOT/ын:MORPH/ған:MORPH
пікірлерден	пікір:ROOT/лер:MORPH/ден:MORPH
жатбауыр	жатбауыр:ROOT
қайшы	қайшы:ROOT
мойындаған	мойын:ROOT/да:MORPH/ған:MORPH
дәрігерді	дәрі:ROOT/гер:MORPH/ді:MORPH
көздейді	көз:ROOT/де:MORPH/й:MORPH/ді:MORPH
қанша	қанша:ROOT
алғанда	ал:ROOT/ған:MORPH/да:MORPH
өзара	өз:ROOT/ара:MORPH
қарабайыр	қарабайыр:ROOT
келісімдер	келіс:ROOT/ім:MORPH/дер:MORPH
марапатталғанын	марапат:ROOT/тал:MORPH/ған:MORPH/ы:MORPH/н:MORPH
латын	латын:ROOT
деп	де:ROOT/п:MORPH
Сократтың	Сократ:ROOT/тың:MORPH
айырылып	айыр:ROOT/ыл:MORPH/ып:MORPH
баяндалады	баян:ROOT/да:MORPH/ла:MORPH/ды:MORPH
анықтай	анық:ROOT/та:MORPH/й:MORPH
жылдары	жыл:ROOT/дар:MORPH/ы:MORPH
мүмкіндік	мүмкін:ROOT/дік:MORPH
сөз	сөз:ROOT
берген	бер:ROOT/ген:MORPH
бөліктерден	бөлік:ROOT/тер:MORPH/ден:MORPH
бәрін	бәр:ROOT/і:MORPH/н:MORPH
мәтіндерге	мәтін:ROOT/дер:MORPH/ге:MORPH
соған	со:ROOT/ған:MORPH
сөздеріне	сөз:ROOT/дер:MORPH/і:MORPH/не:MORPH
Дегенмен	Де:ROOT/ген:MORPH/мен:MORPH
Екінші	Ек:ROOT/інші:MORPH
Симпозиумда	Симпозиум:ROOT/да:MORPH
әйел	әйел:ROOT
алуға	ал:ROOT/у:MORPH/ға:MORPH
сипатын	сипат:ROOT/ы:MORPH/н:MORPH
бөліктерін	бөлік:ROOT/тер:MORPH/ін:MORPH
ғана	ғана:ROOT
қамту	қамт:ROOT/у:MORPH
мен	мен:ROOT
Барша	Барша:ROOT
форма	форма:ROOT
көмектесуін	көмек:ROOT/тес:MORPH/у:MORPH/ін:MORPH
екіұдай	екі:ROOT/ұдай:MORPH
Платонның	Платон:ROOT/ның:MORPH
бар	бар:ROOT
тартысты	тарт:ROOT/ыс:MORPH/ты:MORPH
мәжбүрлеп	мәжбүр:ROOT/ле:MORPH/п:MORPH
мінездемесімен	мінез:ROOT/де:MORPH/ме:MORPH/сі:MORPH/мен:MORPH
көреді	көр:ROOT/е:MORPH/ді:MORPH
өнерге	өнер:ROOT/ге:MORPH
қарымқатынасын	қарымқатынас:ROOT/ы:MORPH/н:MORPH
әсемдікке	әсем:ROOT/дік:MORPH/ке:MORPH
туралы	туралы:ROOT
көңілін	көңіл:ROOT/і:MORPH/н:MORPH
тақырыбына	тақырыбы:ROOT/на:MORPH
шын	шын:ROOT
ол	ол:ROOT
жөнінде	жөн:ROOT/і:MORPH/н:MORPH/де:MORPH
сөздеріне	сөз:ROOT/дер:MORPH/і:MORPH/не:MORPH
ақиқатты	ақиқат:ROOT/ты:MORPH
тұжырымын	тұжырым:ROOT/ы:MORPH/н:MORPH
белгілі	белгілі:ROOT
мойындаудың	мойын:ROOT/да:MORPH/у:MORPH/дың:MORPH
диалогын	диалог:ROOT/ы:MORPH/н:MORPH
ежелгі	ежел:ROOT/гі:MORPH
сенімді	сен:ROOT/ім:MORPH/ді:MORPH
оларды	о:ROOT/лар:MORPH/ды:MORPH
оларды	о:ROOT/лар:MORPH/ды:MORPH
пікірлер	пікір:ROOT/лер:MORPH
Аристофанға	Аристофан:ROOT/ға:MORPH
өмір	өмір:ROOT
Бұл	Бұл:ROOT
фрейдтік	фрейд:ROOT/тік:MORPH
келуімен	кел:ROOT/у:MORPH/і:MORPH/мен:MORPH
туындаған	туын:ROOT/да:MORPH/ған:MORPH
Диалог	Диалог:ROOT
тұрды	тұр:ROOT/ды:MORPH
болсын	бол:ROOT/сын:MORPH
бөліп	бөл:ROOT/іп:MORPH
кірісіп	кір:ROOT/іс:MORPH/іп:MORPH
танысады	таныс:ROOT/а:MORPH/ды:MORPH
туралы	туралы:ROOT
қаланың	қала:ROOT/ның:MORPH
сезім	сез:ROOT/ім:MORPH
бөлімі	бөлім:ROOT/і:MORPH
Оқиға	Оқиға:ROOT
ортасында	орта:ROOT/сы:MORPH/н:MORPH/да:MORPH
нәтижесі	нәтиже:ROOT/сі:MORPH
физика	физика:ROOT
басқару	басқар:ROOT/у:MORPH
көмегімен	көмег:ROOT/і:MORPH/мен:MORPH
бағытталмаған	бағыт:ROOT/тал:MORPH/ма:MORPH/ған:MORPH
бар	бар:ROOT
қолданады	қол:ROOT/дан:MORPH/а:MORPH/ды:MORPH
құдіретті	құдірет:ROOT/ті:MORPH
жылы	жыл:ROOT/ы:MORPH
тарихи	тарих:ROOT/и:MORPH
біреулер	бір:ROOT/еу:MORPH/лер:MORPH
қарсы	қарсы:ROOT
тұсының	тұс:ROOT/ы:MORPH/ның:MORPH
Монпельеге	Монпелье:ROOT/ге:MORPH
өзіндік	өз:ROOT/і:MORPH/н:MORPH/дік:MORPH
potentia	potentia:ROOT
алғашқы	алғаш:ROOT/қы:MORPH
Масайған	Масай:ROOT/ған:MORPH
Платон	Платон:ROOT
логикалық	логика:ROOT/лық:MORPH
Агафон	Агафон:ROOT
өзі	өз:ROOT/і:MORPH
нақты	нақ:ROOT/ты:MORPH
Декарт	Декарт:ROOT
береді	бер:ROOT/е:MORPH/ді:MORPH
бесеудің	бесе:ROOT/у:MORPH/дің:MORPH
лайық	лайық:ROOT
Университетті	Университет:ROOT/ті:MORPH
танымалдығы	таным:ROOT/ал:MORPH/дығ:MORPH/ы:MORPH
аугустинизм	аугустинизм:ROOT
лайықты	лайық:ROOT/ты:MORPH
оларды	о:ROOT/лар:MORPH/ды:MORPH
алатын	ал:ROOT/атын:MORPH
түсіндіруге	түсін:ROOT/дір:MORPH/у:MORPH/ге:MORPH
физика	физика:ROOT
жазылғанын	жаз:ROOT/ыл:MORPH/ған:MORPH/ы:MORPH/н:MORPH
адамдардың	адам:ROOT/дар:MORPH/дың:MORPH
тіршілігі	тір:ROOT/шіліг:MORPH/і:MORPH
көрініс	көрініс:ROOT
поэтикалық	поэтика:ROOT/лық:MORPH
теоремалары	теорема:ROOT/лар:MORPH/ы:MORPH
қылатын	қыл:ROOT/атын:MORPH
даналыққа	дана:ROOT/лық:MORPH/қа:MORPH
мақұлдаған	мақұл:ROOT/да:MORPH/ған:MORPH
Платонға	Платон:ROOT/ға:MORPH
Сократ	Сократ:ROOT
қисынды	қисын:ROOT/ды:MORPH
Өйткені	Өйткені:ROOT
пікірталаста	пікір:ROOT/талас:MORPH/та:MORPH
қарай	қарай:ROOT
лордтың	лорд:ROOT/тың:MORPH
екеуінің	ек:ROOT/еу:MORPH/і:MORPH/нің:MORPH
көрсеткісі	көр:ROOT/се:MORPH/т:MORPH/кісі:MORPH
оқығандықтан	оқы:ROOT/ған:MORPH/дық:MORPH/тан:MORPH
Біреудің	Бір:ROOT/еу:MORPH/дің:MORPH
береді	бер:ROOT/е:MORPH/ді:MORPH
қызмет	қызмет:ROOT
кәсіби	кәсіб:ROOT/и:MORPH
бағыну	бағын:ROOT/у:MORPH
мәнінде	мән:ROOT/і:MORPH/н:MORPH/де:MORPH
әшкерелеп	әшкере:ROOT/ле:MORPH/п:MORPH
көзі	көз:ROOT/і:MORPH
бүгінгі	бүгін:ROOT/гі:MORPH
мен	мен:ROOT
қолданылмайтын	қолдан:ROOT/ыл:MORPH/ма:MORPH/йтын:MORPH
аяулы	аяу:ROOT/лы:MORPH
ойынша	ой:ROOT/ы:MORPH/н:MORPH/ша:MORPH
құралы	құрал:ROOT/ы:MORPH
шығарады	шығ:ROOT/ар:MORPH/а:MORPH/ды:MORPH
ашық	ашық:ROOT
түйсік	түйсік:ROOT
тәжірибесінің	тәжірибе:ROOT/сі:MORPH/нің:MORPH
бекітуге	бекіт:ROOT/у:MORPH/ге:MORPH
сол	сол:ROOT
Бірақ	Бірақ:ROOT
бақытын	бақыт:ROOT/ы:MORPH/н:MORPH
көзқарастар	көз:ROOT/қарастар:MORPH
болып	бол:ROOT/ып:MORPH
лайық	лайық:ROOT
қажымайтын	қажы:ROOT/ма:MORPH/йтын:MORPH
кейін	кейін:ROOT
философиялық	философия:ROOT/лық:MORPH
potestas	potestas:ROOT
қарсы	қарсы:ROOT
міндетті	міндет:ROOT/ті:MORPH
қатысушылардың	қатыс:ROOT/у:MORPH/шы:MORPH/лар:MORPH/дың:MORPH
тұлға	тұлға:ROOT
туралы	туралы:ROOT
айырмашылық	айырма:ROOT/шылық:MORPH
медицина	медицина:ROOT
және	және:ROOT
Декарттың	Декарт:ROOT/тың:MORPH
адамның	адам:ROOT/ның:MORPH
берді	бер:ROOT/ді:MORPH
қарайды	қара:ROOT/й:MORPH/ды:MORPH
елеусіз	елеу:ROOT/сіз:MORPH
мәнері	мәнер:ROOT/і:MORPH
бірқатар	бірқатар:ROOT
сын	сын:ROOT
тым	тым:ROOT
Эшлиді	Эшли:ROOT/ді:MORPH
жауапқа	жауап:ROOT/қа:MORPH
шығармасы	шығ:ROOT/ар:MORPH/ма:MORPH/сы:MORPH
XVII	XVII:ROOT
тұр	тұр:ROOT
бұл	бұл:ROOT
басты	басты:ROOT
көлеңкелер	көлеңке:ROOT/лер:MORPH
алады	ал:ROOT/а:MORPH/ды:MORPH
Өйткені	Өйткені:ROOT
дін	дін:ROOT
философтар	философ:ROOT/тар:MORPH
екенін	е:ROOT/кен:MORPH/і:MORPH/н:MORPH
бір	бір:ROOT
Павсаний	Павсаний:ROOT
мен	мен:ROOT
келген	кел:ROOT/ген:MORPH
дакелмейді	даке:ROOT/л:MORPH/ме:MORPH/й:MORPH/ді:MORPH
ештеңе	ештеңе:ROOT
қарастырылады	қарас:ROOT/тыр:MORPH/ыл:MORPH/а:MORPH/ды:MORPH
қамтуға	қамт:ROOT/у:MORPH/ға:MORPH
тартып	тарт:ROOT/ып:MORPH
болғанға	бол:ROOT/ған:MORPH/ға:MORPH
Аристофанға	Аристофан:ROOT/ға:MORPH
үшін	үшін:ROOT
осының	осы:ROOT/ның:MORPH
жекелеген	жеке:ROOT/ле:MORPH/ген:MORPH
Кант	Кант:ROOT
тастамайды	тас:ROOT/та:MORPH/ма:MORPH/й:MORPH/ды:MORPH
мен	мен:ROOT
жеткізуге	жет:ROOT/кіз:MORPH/у:MORPH/ге:MORPH
Сет	Сет:ROOT
маңызды	маңыз:ROOT/ды:MORPH
дейді	де:ROOT/й:MORPH/ді:MORPH
Сократ	Сократ:ROOT
күнге	күн:ROOT/ге:MORPH
түсінігі	түсініг:ROOT/і:MORPH
атынан	ат:ROOT/ы:MORPH/нан:MORPH
Осындай	Осын:ROOT/дай:MORPH
деген	де:ROOT/ген:MORPH
Платонның	Платон:ROOT/ның:MORPH
Лейбниц	Лейбниц:ROOT
Аристофандар	Аристофандар:ROOT
еңбектерінің	еңбек:ROOT/тер:MORPH/і:MORPH/нің:MORPH
емес	е:ROOT/мес:MORPH
екі	екі:ROOT
ең	ең:ROOT
пен	пен:ROOT
мәжбүр	мәжбүр:ROOT
тіршілік	тір:ROOT/шілік:MORPH
Ортасы	Орта:ROOT/сы:MORPH
ойшылдың	ой:ROOT/шыл:MORPH/дың:MORPH
Сократ	Сократ:ROOT
мүмкін	мүмкін:ROOT
таралуы	тарал:ROOT/у:MORPH/ы:MORPH
мойындайды	мойын:ROOT/да:MORPH/й:MORPH/ды:MORPH
биік	биік:ROOT
ерікқалауымызға	ерікқала:ROOT/у:MORPH/ы:MORPH/мыз:MORPH/ға:MORPH
де	де:ROOT
пікірінше	пікір:ROOT/і:MORPH/н:MORPH/ше:MORPH
есептеу	есеп:ROOT/те:MORPH/у:MORPH
саяси	саяс:ROOT/и:MORPH
әңгімелейді	әңгіме:ROOT/ле:MORPH/й:MORPH/ді:MORPH
де	де:ROOT
ақындар	ақын:ROOT/дар:MORPH
ассоциация	ассоциация:ROOT
ақиқатқа	ақиқат:ROOT/қа:MORPH
басқа	басқа:ROOT
символы	символ:ROOT/ы:MORPH
ақылпарасатқа	ақылпарасат:ROOT/қа:MORPH
барлық	барлық:ROOT
әрқилы	әрқи:ROOT/лы:MORPH
қылып	қыл:ROOT/ып:MORPH
potentia	potentia:ROOT
мейірім	мейірім:ROOT
абыз	абыз:ROOT
ұстанымдарын	ұстан:ROOT/ым:MORPH/да:MORPH/рын:MORPH
негізінен	негіз:ROOT/і:MORPH/нен:MORPH
мен	мен:ROOT
тартады	тарт:ROOT/а:MORPH/ды:MORPH
нәрсе	нәрсе:ROOT
терең	терең:ROOT
қала	қал:ROOT/а:MORPH
ең	ең:ROOT
жатады	жат:ROOT/а:MORPH/ды:MORPH
түпкі	түпкі:ROOT
форма	форма:ROOT
өлім	өлім:ROOT
өзгереді	өз:ROOT/гер:MORPH/е:MORPH/ді:MORPH
үдерісі	үдеріс:ROOT/і:MORPH
айтуға	айт:ROOT/у:MORPH/ға:MORPH
үстінде	үст:ROOT/і:MORPH/н:MORPH/де:MORPH
Аугустин	Аугустин:ROOT
Басқаша	Басқа:ROOT/ша:MORPH
қайғымұңсыз	қайғымұң:ROOT/сыз:MORPH
жоғары	жоғары:ROOT
төрт	төрт:ROOT
жазадан	жаза:ROOT/дан:MORPH
түрлі	түр:ROOT/лі:MORPH
ақиқаттылығының	ақиқат:ROOT/ты:MORPH/лығ:MORPH/ы:MORPH/ның:MORPH
игеру	игер:ROOT/у:MORPH
синонимдер	синоним:ROOT/дер:MORPH
түседі	түс:ROOT/е:MORPH/ді:MORPH
сыбызғышы	сыбыз:ROOT/ғы:MORPH/шы:MORPH
берілген	бер:ROOT/іл:MORPH/ген:MORPH
сенімді	сен:ROOT/ім:MORPH/ді:MORPH
негізі	негіз:ROOT/і:MORPH
кометалар	комета:ROOT/лар:MORPH
құндылығын	құн:ROOT/ды:MORPH/лығ:MORPH/ын:MORPH
кейіпкер	кейіп:ROOT/кер:MORPH
келіседі	келіс:ROOT/е:MORPH/ді:MORPH
пайда	пайда:ROOT
жөнінде	жөн:ROOT/і:MORPH/н:MORPH/де:MORPH
қалауынан	қалау:ROOT/ы:MORPH/нан:MORPH
күрделі	күрделі:ROOT
енді	енді:ROOT
Сократты	Сократ:ROOT/ты:MORPH
осы	осы:ROOT
Марион	Марион:ROOT
ғибратты	ғибрат:ROOT/ты:MORPH
сабақ	сабақ:ROOT
қасаң	қасаң:ROOT
олқы	олқ:ROOT/ы:MORPH
тарихшылары	тарих:ROOT/шы:MORPH/лар:MORPH/ы:MORPH
бастар	бастар:ROOT
Англияға	Англия:ROOT/ға:MORPH
асыруға	асыр:ROOT/у:MORPH/ға:MORPH
ЖРодисЛьюистің	ЖРодисЛьюис:ROOT/тің:MORPH
құрылымы	құрылым:ROOT/ы:MORPH
болады	бол:ROOT/а:MORPH/ды:MORPH
өзара	өзара:ROOT
төрт	төрт:ROOT
және	және:ROOT
көмегімен	көмег:ROOT/і:MORPH/мен:MORPH
пайымдаушы	пайым:ROOT/да:MORPH/у:MORPH/шы:MORPH
оның	о:ROOT/ның:MORPH
олқылығы	олқылығ:ROOT/ы:MORPH
екеуара	ек:ROOT/еуара:MORPH
ды	ды:ROOT
диалогтары	диалог:ROOT/тар:MORPH/ы:MORPH
Мантинеядан	Мантинея:ROOT/дан:MORPH
үлкен	үлкен:ROOT
яғни	яғни:ROOT
келуі	кел:ROOT/у:MORPH/і:MORPH
тартымдылығына	тарт:ROOT/ым:MORPH/дылығ:MORPH/ы:MORPH/на:MORPH
болады	бол:ROOT/а:MORPH/ды:MORPH
кездесуінен	кездес:ROOT/у:MORPH/і:MORPH/нен:MORPH
деп	деп:ROOT
зұлым	зұлым:ROOT
ету	ет:ROOT/у:MORPH
оның	о:ROOT/ның:MORPH
координаттар	координат:ROOT/тар:MORPH
Диоген	Диоген:ROOT
күш	күш:ROOT
көзқарасы	көзқара:ROOT/сы:MORPH
тікелей	тіке:ROOT/лей:MORPH
мәні	мән:ROOT/і:MORPH
ашады	аш:ROOT/а:MORPH/ды:MORPH
әмбебап	әмбебап:ROOT
әрі	әрі:ROOT
кез	кез:ROOT
әрі	әрі:ROOT
ретінде	рет:ROOT/і:MORPH/нде:MORPH
адамның	адам:ROOT/ның:MORPH
шығарды	шығ:ROOT/ар:MORPH/ды:MORPH
одан	о:ROOT/дан:MORPH
түрлі	түр:ROOT/лі:MORPH
Кейінірек	Кейін:ROOT/ірек:MORPH
жүре	жүр:ROOT/е:MORPH
болуы	бол:ROOT/у:MORPH/ы:MORPH
Спинозаның	Спиноза:ROOT/ның:MORPH
болады	бол:ROOT/а:MORPH/ды:MORPH
жанр	жанр:ROOT
ізгіліктері	із:ROOT/гі:MORPH/лік:MORPH/тер:MORPH/і:MORPH
оты	от:ROOT/ы:MORPH
мүмкін	мүмкін:ROOT
бойын	бой:ROOT/ы:MORPH/н:MORPH
Өйткені	Өйткені:ROOT
ұстанымын	ұстаным:ROOT/ын:MORPH
өзге	өз:ROOT/ге:MORPH
бұл	бұл:ROOT
Сократ	Сократ:ROOT
оқуға	оқ:ROOT/у:MORPH/ға:MORPH
мемлекетті	мемлекет:ROOT/ті:MORPH
интеллектуалдық	интеллектуал:ROOT/дық:MORPH
тұрады	тұр:ROOT/а:MORPH/ды:MORPH
Жанның	Жан:ROOT/ның:MORPH
махаббат	махаббат:ROOT
рух	рух:ROOT
анықтамалар	анық:ROOT/тама:MORPH/лар:MORPH
Платон	Платон:ROOT
бақытқа	бақыт:ROOT/қа:MORPH
енгізуді	енгіз:ROOT/у:MORPH/ді:MORPH
беделі	бедел:ROOT/і:MORPH
ашкөз	ашкөз:ROOT
Енді	Енді:ROOT
және	және:ROOT
жағдайға	жағдай:ROOT/ға:MORPH
саясаткерлер	саясат:ROOT/кер:MORPH/лер:MORPH
салдарын	салдар:ROOT/ы:MORPH/н:MORPH
Бірақ	Бірақ:ROOT
жүруі	жүр:ROOT/у:MORPH/і:MORPH
арасындағы	ара:ROOT/сы:MORPH/нда:MORPH/ғы:MORPH
сауалына	сауал:ROOT/ы:MORPH/на:MORPH
тыйым	тыйым:ROOT
тіліне	тіл:ROOT/і:MORPH/не:MORPH
дереккөзі	дереккөзі:ROOT
үздіксіз	үздік:ROOT/сіз:MORPH
пікіріне	пікір:ROOT/і:MORPH/не:MORPH
болатын	бол:ROOT/атын:MORPH
дегеніміз	деген:ROOT/і:MORPH/міз:MORPH
жан	жан:ROOT
модельді	модель:ROOT/ді:MORPH
философ	философ:ROOT
да	да:ROOT
құрылысын	құр:ROOT/ыл:MORPH/ыс:MORPH/ы:MORPH/н:MORPH
болса	бол:ROOT/са:MORPH
сөздің	сөз:ROOT/дің:MORPH
диалогтарға	диалог:ROOT/тар:MORPH/ға:MORPH
дәл	дәл:ROOT
Фалес	Фалес:ROOT
софистикамен	софистика:ROOT/мен:MORPH
ұқсамайтын	ұқса:ROOT/ма:MORPH/йтын:MORPH
шығармада	шығ:ROOT/ар:MORPH/ма:MORPH/да:MORPH
баяндап	баян:ROOT/да:MORPH/п:MORPH
Эшли	Эшли:ROOT
көрсетеді	көр:ROOT/се:MORPH/т:MORPH/е:MORPH/ді:MORPH
пікірінше	пікір:ROOT/і:MORPH/н:MORPH/ше:MORPH
бар	бар:ROOT
тек	тек:ROOT
шығармаларын	шығ:ROOT/ар:MORPH/ма:MORPH/лар:MORPH/ы:MORPH/н:MORPH
Сократ	Сократ:ROOT
бастайды	бас:ROOT/та:MORPH/й:MORPH/ды:MORPH
тиіс	тиіс:ROOT
игілігі	игі:ROOT/ліг:MORPH/і:MORPH
бірі	бір:ROOT/і:MORPH
жазды	жаз:ROOT/ды:MORPH
ғылым	ғылым:ROOT
тоқтайды	тоқта:ROOT/й:MORPH/ды:MORPH
билік	би:ROOT/лік:MORPH
осымен	осы:ROOT/мен:MORPH
парасаттылық	парасат:ROOT/ты:MORPH/лық:MORPH
мінсіз	мін:ROOT/сіз:MORPH
картезиандық	картезиан:ROOT/дық:MORPH
оның	о:ROOT/ның:MORPH
Алкивиад	Алкивиад:ROOT
геометриядан	геометрия:ROOT/дан:MORPH
жауап	жауап:ROOT
ақындар	ақын:ROOT/дар:MORPH
мәнін	мән:ROOT/і:MORPH/н:MORPH
келген	кел:ROOT/ген:MORPH
өзекті	өзек:ROOT/ті:MORPH
жанның	жан:ROOT/ның:MORPH
философиядан	философия:ROOT/дан:MORPH
үңгірге	үңгір:ROOT/ге:MORPH
Содан	Со:ROOT/дан:MORPH
сұхбаттарда	сұхбат:ROOT/тар:MORPH/да:MORPH
қабылдауға	қабыл:ROOT/да:MORPH/у:MORPH/ға:MORPH
екі	екі:ROOT
өрлеп	өрл:ROOT/еп:MORPH
шертеді	шерт:ROOT/е:MORPH/ді:MORPH
болжамдарға	болжам:ROOT/дар:MORPH/ға:MORPH
қазір	қазір:ROOT
біріктірілген	бірік:ROOT/тір:MORPH/іл:MORPH/ген:MORPH
Ойын	Ой:ROOT/ы:MORPH/н:MORPH
интеллектуалдық	интеллектуал:ROOT/дық:MORPH
маған	ма:ROOT/ған:MORPH
ғана	ғана:ROOT
мәселе	мәселе:ROOT
сүремін	сүр:ROOT/е:MORPH/мін:MORPH
өз	өз:ROOT
әлемнің	әлем:ROOT/нің:MORPH
да	да:ROOT
мезетте	мезет:ROOT/те:MORPH
бүкіл	бүкіл:ROOT
соған	со:ROOT/ған:MORPH
қалу	қал:ROOT/у:MORPH
оның	о:ROOT/ның:MORPH
кездестіреміз	кездес:ROOT/тір:MORPH/е:MORPH/міз:MORPH
байланысты	байланыс:ROOT/ты:MORPH
уақыт	уақыт:ROOT
бірнеше	бір:ROOT/неше:MORPH
кәсіп	кәсіп:ROOT
туралы	туралы:ROOT
тұрған	тұр:ROOT/ған:MORPH
жазады	жаз:ROOT/а:MORPH/ды:MORPH
тұратын	тұр:ROOT/атын:MORPH
салиқалы	салиқа:ROOT/лы:MORPH
адам	адам:ROOT
билікті	би:ROOT/лік:MORPH/ті:MORPH
тән	тән:ROOT
жылға	жыл:ROOT/ға:MORPH
таңқалдырды	таңқал:ROOT/дыр:MORPH/ды:MORPH
Енді	Енді:ROOT
объектілер	объекті:ROOT/лер:MORPH
мүмкін	мүмкін:ROOT
және	және:ROOT
кітабын	кітаб:ROOT/ы:MORPH/н:MORPH
айналуының	айнал:ROOT/у:MORPH/ы:MORPH/ның:MORPH
еңбегі	еңбе:ROOT/гі:MORPH
құрсаулау	құрсау:ROOT/ла:MORPH/у:MORPH
өзі	өз:ROOT/і:MORPH
ой	ой:ROOT
ғажайып	ғажайып:ROOT
тұрып	тұр:ROOT/ып:MORPH
жіберуді	жібер:ROOT/у:MORPH/ді:MORPH
бейне	бейне:ROOT
білім	біл:ROOT/ім:MORPH
білетінiміздей	біл:ROOT/етін:MORPH/iміз:MORPH/дей:MORPH
өте	өте:ROOT
адамды	адам:ROOT/ды:MORPH
арасындағы	ара:ROOT/сы:MORPH/нда:MORPH/ғы:MORPH
тиіп	ти:ROOT/іп:MORPH
алмай	ал:ROOT/ма:MORPH/й:MORPH
келді	кел:ROOT/ді:MORPH
сипаттайды	сипат:ROOT/та:MORPH/й:MORPH/ды:MORPH
тоғысқанымен	тоғыс:ROOT/қан:MORPH/ы:MORPH/мен:MORPH
мүмкіндік	мүмкін:ROOT/дік:MORPH
Сондықтан	Сондықтан:ROOT
тапсырамын	тапсыр:ROOT/а:MORPH/мын:MORPH
да	да:ROOT
Сондықтан	Сондық:ROOT/тан:MORPH
Энтони	Энтони:ROOT
өмірі	өмір:ROOT/і:MORPH
тұрады	тұр:ROOT/а:MORPH/ды:MORPH
біреулері	бір:ROOT/еу:MORPH/лер:MORPH/і:MORPH
мезетте	мезет:ROOT/те:MORPH
кітапқа	кітап:ROOT/қа:MORPH
жаңа	жаңа:ROOT
бұл	бұл:ROOT
шын	шын:ROOT
бермеуін	бер:ROOT/ме:MORPH/у:MORPH/і:MORPH/н:MORPH
әлемінде	әлем:ROOT/і:MORPH/н:MORPH/де:MORPH
жарылған	жар:ROOT/ыл:MORPH/ған:MORPH
өзінің	өз:ROOT/і:MORPH/нің:MORPH
қозғалысқа	қозғалыс:ROOT/қа:MORPH
басты	бас:ROOT/ты:MORPH
тиесілі	тиесі:ROOT/лі:MORPH
Өйткені	Өйткені:ROOT
тән	тән:ROOT
кеңейте	кеңей:ROOT/т:MORPH/е:MORPH
бастапқы	бастап:ROOT/қы:MORPH
табуда	табу:ROOT/да:MORPH
білеміз	біл:ROOT/е:MORPH/міз:MORPH
Өзінің	Өз:ROOT/і:MORPH/нің:MORPH
жүгіне	жүгін:ROOT/е:MORPH
табиғатын	табиғат:ROOT/ы:MORPH/н:MORPH
сөзінің	сөз:ROOT/і:MORPH/нің:MORPH
теориялық	теория:ROOT/лық:MORPH
түрінде	түр:ROOT/і:MORPH/н:MORPH/де:MORPH
ол	ол:ROOT
тарыдай	тары:ROOT/дай:MORPH
Шығарманы	Шығ:ROOT/ар:MORPH/ма:MORPH/ны:MORPH
Бэкон	Бэкон:ROOT
жекеге	жеке:ROOT/ге:MORPH
тақырыбы	тақырыб:ROOT/ы:MORPH
достық	дос:ROOT/тық:MORPH
адамдар	адам:ROOT/дар:MORPH
көруге	көр:ROOT/у:MORPH/ге:MORPH
идеялар	идея:ROOT/лар:MORPH
ер	ер:ROOT
Теофил	Теофил:ROOT
Сократ	Сократ:ROOT
ғалымфизик	ғалымфизик:ROOT
алдымен	алдымен:ROOT
болғанын	болға:ROOT/нын:MORPH
ред	ред:ROOT
ауыр	ауыр:ROOT
танымал	танымал:ROOT
ақиқатқа	ақиқат:ROOT/қа:MORPH
жиі	жиі:ROOT
кезінде	кез:ROOT/і:MORPH/н:MORPH/де:MORPH
жасалады	жаса:ROOT/л:MORPH/а:MORPH/ды:MORPH
сәт	сәт:ROOT
соң	соң:ROOT
қолына	қол:ROOT/ы:MORPH/на:MORPH
алмасуға	алмас:ROOT/у:MORPH/ға:MORPH
қолдану	қолдан:ROOT/у:MORPH
Платон	Платон:ROOT
бірден	бір:ROOT/ден:MORPH
көрсетен	көр:ROOT/се:MORPH/т:MORPH/ен:MORPH
мақалы	мақал:ROOT/ы:MORPH
ғана	ғана:ROOT
болып	бол:ROOT/ып:MORPH
бірлігін	бір:ROOT/ліг:MORPH/і:MORPH/н:MORPH
ерекше	ерекше:ROOT
теориялар	теория:ROOT/лар:MORPH
кенеттен	кенет:ROOT/тен:MORPH
біртұтас	бір:ROOT/тұтас:MORPH
де	де:ROOT
Өйткені	Өйткені:ROOT
зерттеу	зерт:ROOT/те:MORPH/у:MORPH
ал	ал:ROOT
жазған	жаз:ROOT/ған:MORPH
деп	де:ROOT/п:MORPH
мүлде	мүлде:ROOT
ал	ал:ROOT
аламыз	ала:ROOT/мыз:MORPH
тарауды	тарау:ROOT/ды:MORPH
алайық	ала:ROOT/й:MORPH/ық:MORPH
пайымдаудың	пайым:ROOT/да:MORPH/у:MORPH/дың:MORPH
арнасына	арна:ROOT/сы:MORPH/на:MORPH
беруге	бер:ROOT/у:MORPH/ге:MORPH
байланыстырылады	байланыс:ROOT/тыр:MORPH/ыл:MORPH/а:MORPH/ды:MORPH
философ	философ:ROOT
қалпында	қалп:ROOT/ы:MORPH/н:MORPH/да:MORPH
өзін	өз:ROOT/і:MORPH/н:MORPH
Сократ	Сократ:ROOT
жалғасты	жалғас:ROOT/ты:MORPH
жылы	жылы:ROOT
объективті	объектив:ROOT/ті:MORPH
ұдайы	ұдайы:ROOT
Бойльмен	Бойль:ROOT/мен:MORPH
Пайымның	Пайым:ROOT/ның:MORPH
өтті	өт:ROOT/ті:MORPH
қозғалысқа	қозғалыс:ROOT/қа:MORPH
хабардар	хабар:ROOT/дар:MORPH
баяндаған	баян:ROOT/да:MORPH/ған:MORPH
санамен	сана:ROOT/мен:MORPH
Жильсон	Жильсон:ROOT
әңгімеге	әңгіме:ROOT/ге:MORPH
туралы	туралы:ROOT
беру	бер:ROOT/у:MORPH
Өйткені	Өйткені:ROOT
деп	деп:ROOT
қарсы	қарсы:ROOT
кітап	кітап:ROOT
Эроста	Эрос:ROOT/та:MORPH
түрінде	түр:ROOT/і:MORPH/н:MORPH/де:MORPH
сол	сол:ROOT
Осылайша	Осылайша:ROOT
мәлімдейтін	мәлім:ROOT/де:MORPH/йтін:MORPH
Бірақ	Бірақ:ROOT
көрсетеді	көр:ROOT/се:MORPH/т:MORPH/е:MORPH/ді:MORPH
көлеңкелерді	көлеңке:ROOT/лер:MORPH/ді:MORPH
бір	бір:ROOT
Пікірталаста	Пікір:ROOT/талас:MORPH/та:MORPH
үйрететін	үйрет:ROOT/етін:MORPH
сезімі	сез:ROOT/ім:MORPH/і:MORPH
оңайға	оңай:ROOT/ға:MORPH
сонша	сонша:ROOT
адамның	адам:ROOT/ның:MORPH
еңбектерін	еңбек:ROOT/тер:MORPH/і:MORPH/н:MORPH
егжейтегжейлі	егжейтегжей:ROOT/лі:MORPH
болады	бол:ROOT/а:MORPH/ды:MORPH
болмыстың	бол:ROOT/мыс:MORPH/тың:MORPH
болар	бол:ROOT/ар:MORPH
тіршіліктің	тірші:ROOT/лік:MORPH/тің:MORPH
жөніндегі	жөн:ROOT/і:MORPH/н:MORPH/де:MORPH/гі:MORPH
Философ	Философ:ROOT
Аристофан	Аристофан:ROOT
дегеніміз	де:ROOT/ген:MORPH/іміз:MORPH
мәңгілік	мәңгілік:ROOT
көзін	көз:ROOT/і:MORPH/н:MORPH
һәм	һәм:ROOT
төңіректі	төңірек:ROOT/ті:MORPH
деген	де:ROOT/ген:MORPH
сөздерінде	сөз:ROOT/дер:MORPH/і:MORPH/н:MORPH/де:MORPH
шығармасынан	шығ:ROOT/ар:MORPH/ма:MORPH/сы:MORPH/нан:MORPH
Кейбір	Кей:ROOT/бір:MORPH
мысалы	мысалы:ROOT
метафизиканың	метафизика:ROOT/ның:MORPH
сөзін	сөз:ROOT/ін:MORPH
қонақтардың	қонақ:ROOT/тар:MORPH/дың:MORPH
ғылым	ғылым:ROOT
қала	қала:ROOT
ақиқатты	ақиқат:ROOT/ты:MORPH
жалғыз	жалғыз:ROOT
болады	бол:ROOT/а:MORPH/ды:MORPH
ұстазының	ұстаз:ROOT/ы:MORPH/ның:MORPH
тұрғанын	тұр:ROOT/ған:MORPH/ы:MORPH/н:MORPH
шешендердің	шешен:ROOT/дер:MORPH/дің:MORPH
Пайымды	Пайым:ROOT/ды:MORPH
өзінің	өз:ROOT/і:MORPH/нің:MORPH
тұста	тұс:ROOT/та:MORPH
шығатын	шығ:ROOT/атын:MORPH
күлкіні	күлкі:ROOT/ні:MORPH
тарихын	тарих:ROOT/ы:MORPH/н:MORPH
ретінде	рет:ROOT/і:MORPH/нде:MORPH
қозғамаған	қозға:ROOT/ма:MORPH/ған:MORPH
биік	биік:ROOT
ерінің	ер:ROOT/і:MORPH/нің:MORPH
немесе	немесе:ROOT
біз	біз:ROOT
бар	бар:ROOT
жатқаны	жат:ROOT/қан:MORPH/ы:MORPH
екінші	екі:ROOT/нші:MORPH
қарамастан	қара:ROOT/мас:MORPH/тан:MORPH
қақ	қақ:ROOT
дағдылы	дағды:ROOT/лы:MORPH
көшеді	көш:ROOT/е:MORPH/ді:MORPH
Философ	Философ:ROOT
жұмыс	жұмыс:ROOT
келгенде	кел:ROOT/ген:MORPH/де:MORPH
барынан	бар:ROOT/ы:MORPH/нан:MORPH
қалыптастыруға	қалып:ROOT/тас:MORPH/тыр:MORPH/у:MORPH/ға:MORPH
пікірдің	пікір:ROOT/дің:MORPH
рет	рет:ROOT
бойлатуға	бой:ROOT/ла:MORPH/т:MORPH/у:MORPH/ға:MORPH
аралықта	ара:ROOT/лық:MORPH/та:MORPH
құқығын	құқығ:ROOT/ы:MORPH/н:MORPH
мәңгілік	мәңгі:ROOT/лік:MORPH
аузына	ауз:ROOT/ы:MORPH/на:MORPH
тұтастай	тұтас:ROOT/тай:MORPH
ред	ред:ROOT
мен	мен:ROOT
өлім	өлім:ROOT
тұрғаны	тұр:ROOT/ған:MORPH/ы:MORPH
жетудің	жет:ROOT/у:MORPH/дің:MORPH
билікті	билік:ROOT/ті:MORPH
адамдар	адам:ROOT/дар:MORPH
себепші	себеп:ROOT/ші:MORPH
Франсуа	Франсуа:ROOT
Сократқа	Сократ:ROOT/қа:MORPH
таңдаулы	таңдау:ROOT/лы:MORPH
әжуаға	әжуа:ROOT/ға:MORPH
бірге	бірге:ROOT
сұлу	сұлу:ROOT
Месланд	Месланд:ROOT
Теледидардың	Теледидар:ROOT/дың:MORPH
еткен	ет:ROOT/кен:MORPH
екі	екі:ROOT
өзінің	өз:ROOT/і:MORPH/нің:MORPH
дән	дән:ROOT
сәйкес	сәйкес:ROOT
салады	сал:ROOT/а:MORPH/ды:MORPH
өзгереді	өзгер:ROOT/е:MORPH/ді:MORPH
алтын	алтын:ROOT
ұстаздың	ұстаз:ROOT/дың:MORPH
бірігуіне	біріг:ROOT/у:MORPH/і:MORPH/не:MORPH
армандаған	арман:ROOT/да:MORPH/ған:MORPH
жөн	жөн:ROOT
үміті	үміт:ROOT/і:MORPH
тақырыптағы	тақырып:ROOT/та:MORPH/ғы:MORPH
табиғат	табиғат:ROOT
даналықтың	дана:ROOT/лық:MORPH/тың:MORPH
олардың	о:ROOT/лар:MORPH/дың:MORPH
Пайымда	Пайым:ROOT/да:MORPH
да	да:ROOT
Платонды	Платон:ROOT/ды:MORPH
деуімізге	де:ROOT/у:MORPH/іміз:MORPH/ге:MORPH
жадырататын	жадыра:ROOT/т:MORPH/атын:MORPH
оны	о:ROOT/ны:MORPH
болмайтын	бол:ROOT/ма:MORPH/йтын:MORPH
осы	осы:ROOT
сипат	сипат:ROOT
жыл	жыл:ROOT
дәлелдейді	дәлел:ROOT/де:MORPH/й:MORPH/ді:MORPH
деген	де:ROOT/ген:MORPH
әртүрлі	әр:ROOT/түр:MORPH/лі:MORPH
тұрғыдан	тұр:ROOT/ғы:MORPH/дан:MORPH
теориясы	теория:ROOT/сы:MORPH
де	де:ROOT
Платонның	Платон:ROOT/ның:MORPH
негізгі	негіз:ROOT/гі:MORPH
терең	терең:ROOT
табатын	таб:ROOT/атын:MORPH
өрлеудің	өр:ROOT/ле:MORPH/у:MORPH/дің:MORPH
бұла	бұла:ROOT
әдісті	әдіс:ROOT/ті:MORPH
жеткізеді	жет:ROOT/кіз:MORPH/е:MORPH/ді:MORPH
тағлым	тағл:ROOT/ым:MORPH
анық	анық:ROOT
Жеке	Жеке:ROOT
түсіндіруге	түс:ROOT/ін:MORPH/дір:MORPH/у:MORPH/ге:MORPH
үміт	үміт:ROOT
түйсіну	түйсін:ROOT/у:MORPH
мәнмаңызы	мәнмаңыз:ROOT/ы:MORPH
ме	ме:ROOT
метафизикада	метафизика:ROOT/да:MORPH
ме	ме:ROOT
оған	о:ROOT/ған:MORPH
мән	мән:ROOT
Сократ	Сократ:ROOT
ой	ой:ROOT
ақиқаттың	ақиқат:ROOT/тың:MORPH
жоқ	жоқ:ROOT
әңгімесінен	әңгіме:ROOT/сі:MORPH/нен:MORPH
мәнер	мәнер:ROOT
оқимыз	оқи:ROOT/мыз:MORPH
әрі	әрі:ROOT
шақырған	шақыр:ROOT/ған:MORPH
сөзі	сөз:ROOT/і:MORPH
көрінеді	көр:ROOT/ін:MORPH/е:MORPH/ді:MORPH
өзөзінен	өзөз:ROOT/і:MORPH/нен:MORPH
қабылдауға	қабыл:ROOT/да:MORPH/у:MORPH/ға:MORPH
Сократ	Сократ:ROOT
қосылады	қос:ROOT/ыл:MORPH/а:MORPH/ды:MORPH
да	да:ROOT
тәсіл	тәсіл:ROOT
дәлелдер	дәлел:ROOT/дер:MORPH
келіп	кел:ROOT/іп:MORPH
білді	біл:ROOT/ді:MORPH
Эриксимахқа	Эриксимах:ROOT/қа:MORPH
көзқарастарымен	көз:ROOT/қарас:MORPH/тар:MORPH/ы:MORPH/мен:MORPH
заңдылыққа	заң:ROOT/дылық:MORPH/қа:MORPH
қаупі	қауп:ROOT/і:MORPH
метафизикасын	метафизика:ROOT/сын:MORPH
деген	де:ROOT/ген:MORPH
білдіруге	біл:ROOT/дір:MORPH/у:MORPH/ге:MORPH
қатар	қатар:ROOT
саптасы	саптас:ROOT/ы:MORPH
Сатир	Сатир:ROOT
байсалды	байсал:ROOT/ды:MORPH
философтар	философ:ROOT/тар:MORPH
басқаша	басқаша:ROOT
Сократ	Сократ:ROOT
өміріне	өмір:ROOT/і:MORPH/не:MORPH
қыздардың	қыз:ROOT/дар:MORPH/дың:MORPH
Спинозаның	Спиноза:ROOT/ның:MORPH
үзілдікесілді	үз:ROOT/іл:MORPH/дікес:MORPH/іл:MORPH/ді:MORPH
Атақты	Атақ:ROOT/ты:MORPH
Игілікке	Игі:ROOT/лік:MORPH/ке:MORPH
зерделенеді	зерде:ROOT/лен:MORPH/е:MORPH/ді:MORPH
Бұл	Бұл:ROOT
еңбектерін	еңбек:ROOT/тер:MORPH/і:MORPH/н:MORPH
және	және:ROOT
атап	ата:ROOT/п:MORPH
сенімділікпен	сен:ROOT/ім:MORPH/ді:MORPH/лік:MORPH/пен:MORPH
адамдар	адам:ROOT/дар:MORPH
ойының	ой:ROOT/ы:MORPH/ның:MORPH
нәрсе	нәрсе:ROOT
жан	жан:ROOT
тәржімелеуімен	тәржі:ROOT/ме:MORPH/ле:MORPH/у:MORPH/і:MORPH/мен:MORPH
итжығыс	ит:ROOT/жығыс:MORPH
еңбегінің	еңбег:ROOT/і:MORPH/нің:MORPH
деректерге	дерек:ROOT/тер:MORPH/ге:MORPH
өлімі	өлім:ROOT/і:MORPH
айтыста	айтыс:ROOT/та:MORPH
арасынан	ара:ROOT/сы:MORPH/нан:MORPH
жас	жас:ROOT
болып	бол:ROOT/ып:MORPH
Ережелер	Ереже:ROOT/лер:MORPH
үш	үш:ROOT
бұрын	бұрын:ROOT
мәні	мән:ROOT/і:MORPH
бірбірін	бірбір:ROOT/і:MORPH/н:MORPH
келеді	кел:ROOT/е:MORPH/ді:MORPH
бағытталған	бағыт:ROOT/тал:MORPH/ған:MORPH
әлеміндегі	әлемін:ROOT/де:MORPH/гі:MORPH
негізі	негіз:ROOT/і:MORPH
қарастырылады	қарас:ROOT/тыр:MORPH/ыл:MORPH/а:MORPH/ды:MORPH
ойымды	ой:ROOT/ым:MORPH/ды:MORPH
көрсетіңізші	көр:ROOT/се:MORPH/т:MORPH/іңіз:MORPH/ші:MORPH
тығырықтан	тығырық:ROOT/тан:MORPH
комедиограф	комедио:ROOT/граф:MORPH
сұраған	сұр:ROOT/а:MORPH/ған:MORPH
бітімі	бітім:ROOT/і:MORPH
жұмсартатын	жұмсар:ROOT/т:MORPH/атын:MORPH
өз	өз:ROOT
Адамды	Адам:ROOT/ды:MORPH
сене	сене:ROOT
қабырғаларында	қабырға:ROOT/лар:MORPH/ы:MORPH/н:MORPH/да:MORPH
құралдары	құрал:ROOT/дар:MORPH/ы:MORPH
Сократтың	Сократ:ROOT/тың:MORPH
лауазымына	лауазым:ROOT/ы:MORPH/на:MORPH
тіліне	тіл:ROOT/і:MORPH/не:MORPH
Ол	Ол:ROOT
ойлауға	ойла:ROOT/у:MORPH/ға:MORPH
Ол	Ол:ROOT
Геометриялық	Геометрия:ROOT/лық:MORPH
тоқтау	тоқта:ROOT/у:MORPH
әбден	әбден:ROOT
дәлелдеп	дәлел:ROOT/де:MORPH/п:MORPH
дене	дене:ROOT
еліктіріп	елік:ROOT/тір:MORPH/іп:MORPH
қояды	қоя:ROOT/ды:MORPH
Сократ	Сократ:ROOT
болғанын	бол:ROOT/ған:MORPH/ы:MORPH/н:MORPH
кеңес	кеңес:ROOT
жету	жет:ROOT/у:MORPH
қуаныш	қуаныш:ROOT
мен	мен:ROOT
құлға	құл:ROOT/ға:MORPH
одақтың	одақ:ROOT/тың:MORPH
құмарлығын	құмар:ROOT/лығ:MORPH/ын:MORPH
қажетті	қажет:ROOT/ті:MORPH
мен	мен:ROOT
Уильям	Уильям:ROOT
тіршілік	тірші:ROOT/лік:MORPH
трактатын	трактат:ROOT/ы:MORPH/н:MORPH
оны	о:ROOT/ны:MORPH
түрдегі	түр:ROOT/де:MORPH/гі:MORPH
арнаға	арна:ROOT/ға:MORPH
тікелей	тіке:ROOT/лей:MORPH
бір	бір:ROOT
де	де:ROOT
деп	деп:ROOT
бірбірімен	бірбір:ROOT/і:MORPH/мен:MORPH
Осы	Осы:ROOT
әлемде	әлем:ROOT/де:MORPH
тұжырымдай	тұжырым:ROOT/да:MORPH/й:MORPH
етіп	ет:ROOT/іп:MORPH
Локк	Локк:ROOT
келеді	кел:ROOT/е:MORPH/ді:MORPH
келіп	кел:ROOT/іп:MORPH
сенімді	сен:ROOT/ім:MORPH/ді:MORPH
Басқа	Басқа:ROOT
Дүниедегі	Дүние:ROOT/де:MORPH/гі:MORPH
үшін	үшін:ROOT
философияға	философия:ROOT/ға:MORPH
өткендей	өт:ROOT/кен:MORPH/дей:MORPH
көрнекті	көрнек:ROOT/ті:MORPH
шығармаға	шығ:ROOT/ар:MORPH/ма:MORPH/ға:MORPH
кірісіп	кір:ROOT/іс:MORPH/іп:MORPH
қозғалған	қозға:ROOT/л:MORPH/ған:MORPH
осы	осы:ROOT
potestas	potestas:ROOT
оларға	о:ROOT/лар:MORPH/ға:MORPH
дұрыс	дұрыс:ROOT
алмайтыны	ал:ROOT/ма:MORPH/йтыны:MORPH
трактатының	трактат:ROOT/ы:MORPH/ның:MORPH
философиялық	философия:ROOT/лық:MORPH
жасанды	жаса:ROOT/нды:MORPH
дұрыс	дұрыс:ROOT
отырып	отыр:ROOT/ып:MORPH
есімі	есім:ROOT/і:MORPH
білгірлер	біл:ROOT/гір:MORPH/лер:MORPH
қалыптастыруға	қалып:ROOT/тас:MORPH/тыр:MORPH/у:MORPH/ға:MORPH
ең	ең:ROOT
көреді	көр:ROOT/е:MORPH/ді:MORPH
оның	о:ROOT/ның:MORPH
пікірлерді	пікір:ROOT/лер:MORPH/ді:MORPH
пікірі	пікір:ROOT/і:MORPH
жеделдету	жедел:ROOT/де:MORPH/т:MORPH/у:MORPH
терең	терең:ROOT
Гегельдер	Гегельдер:ROOT
адам	адам:ROOT
жан	жан:ROOT
айтыс	айт:ROOT/ыс:MORPH
қамқорлық	қамқор:ROOT/лық:MORPH
осындай	осын:ROOT/дай:MORPH
көлеңкелерді	көлеңке:ROOT/лер:MORPH/ді:MORPH
үнемі	үнемі:ROOT
бұрынғы	бұрын:ROOT/ғы:MORPH
қалыптастырғысы	қалыптас:ROOT/тыр:MORPH/ғы:MORPH/сы:MORPH
идеяларының	идея:ROOT/лар:MORPH/ы:MORPH/ның:MORPH
диалогтың	диалог:ROOT/тың:MORPH
емес	е:ROOT/мес:MORPH
Ол	Ол:ROOT
ауқымын	ауқ:ROOT/ым:MORPH/ы:MORPH/н:MORPH
құқыққа	құқық:ROOT/қа:MORPH
арқылы	арқылы:ROOT
тұста	тұс:ROOT/та:MORPH
ықылық	ықы:ROOT/лық:MORPH
беруді	бер:ROOT/у:MORPH/ді:MORPH
едәуір	едәуір:ROOT
жататынын	жат:ROOT/атын:MORPH/ы:MORPH/н:MORPH
сипат	сипат:ROOT
айтып	айт:ROOT/ып:MORPH
білем	біл:ROOT/ем:MORPH
Павсанийдің	Павсаний:ROOT/дің:MORPH
тудыратын	ту:ROOT/дыр:MORPH/атын:MORPH
болмысымен	бол:ROOT/мыс:MORPH/ы:MORPH/мен:MORPH
шарты	шарт:ROOT/ы:MORPH
тұжырымдамалық	тұжырым:ROOT/дама:MORPH/лық:MORPH
білдіреді	біл:ROOT/дір:MORPH/е:MORPH/ді:MORPH
құдірет	құдірет:ROOT
Шын	Шын:ROOT
махаббат	махаббат:ROOT
ішінде	іш:ROOT/і:MORPH/н:MORPH/де:MORPH
картезиандық	картезиан:ROOT/дық:MORPH
алғанда	ал:ROOT/ған:MORPH/да:MORPH
Себебі	Себеб:ROOT/і:MORPH
қозғалыс	қозғ:ROOT/ал:MORPH/ыс:MORPH
яғни	яғни:ROOT
бұлайша	бұ:ROOT/лай:MORPH/ша:MORPH
өзінің	өз:ROOT/і:MORPH/нің:MORPH
сөзіне	сөз:ROOT/і:MORPH/не:MORPH
таным	тан:ROOT/ым:MORPH
билеуі	биле:ROOT/у:MORPH/і:MORPH
сөздерімен	сөз:ROOT/дер:MORPH/і:MORPH/мен:MORPH
қоюға	қо:ROOT/ю:MORPH/ға:MORPH
кейіпкер	кейіп:ROOT/кер:MORPH
айтқанда	айт:ROOT/қан:MORPH/да:MORPH
де	де:ROOT
бергенін	бер:ROOT/ген:MORPH/ін:MORPH
ғалымгеометр	ғалымгеометр:ROOT
белгілі	белгі:ROOT/лі:MORPH
шындап	шын:ROOT/дап:MORPH
килігулерге	киліг:ROOT/у:MORPH/лер:MORPH/ге:MORPH
Иә	Иә:ROOT
ред	ред:ROOT
әлі	әлі:ROOT
сұхбаттың	сұхбат:ROOT/тың:MORPH
сәйкес	сәйкес:ROOT
жерде	жер:ROOT/де:MORPH
ішіндегі	іш:ROOT/і:MORPH/н:MORPH/де:MORPH/гі:MORPH
атап	ата:ROOT/п:MORPH
жақтастары	жақтас:ROOT/тар:MORPH/ы:MORPH
тырысады	тырыс:ROOT/а:MORPH/ды:MORPH
түсіндіруге	түсін:ROOT/дір:MORPH/у:MORPH/ге:MORPH
арасында	ара:ROOT/сы:MORPH/н:MORPH/да:MORPH
жазған	жаз:ROOT/ған:MORPH
түрлі	түрлі:ROOT
екенін	е:ROOT/кен:MORPH/і:MORPH/н:MORPH
қайғы	қайғы:ROOT
бермегендіктен	бер:ROOT/ме:MORPH/ген:MORPH/дік:MORPH/тен:MORPH
хал	хал:ROOT
өзіндеақ	өз:ROOT/і:MORPH/н:MORPH/деақ:MORPH
өз	өз:ROOT
шынайы	шын:ROOT/айы:MORPH
Агафонның	Агафон:ROOT/ның:MORPH
ең	ең:ROOT
негізгі	негіз:ROOT/гі:MORPH
анықтап	анық:ROOT/та:MORPH/п:MORPH
ортаға	орта:ROOT/ға:MORPH
шығып	шығ:ROOT/ып:MORPH
белгілі	белгі:ROOT/лі:MORPH
етеді	ет:ROOT/е:MORPH/ді:MORPH
келген	кел:ROOT/ген:MORPH
соң	соң:ROOT
ғалымдығымен	ғалым:ROOT/дығ:MORPH/ы:MORPH/мен:MORPH
көрсетеді	көр:ROOT/се:MORPH/т:MORPH/е:MORPH/ді:MORPH
салыстыру	салыстыр:ROOT/у:MORPH
екінші	ек:ROOT/інші:MORPH
бұл	бұл:ROOT
сол	сол:ROOT
cogitoсы	cogitoсы:ROOT
Гоббс	Гоббс:ROOT
көздейді	көз:ROOT/де:MORPH/й:MORPH/ді:MORPH
Ақыр	Ақыр:ROOT
әділдік	әділ:ROOT/дік:MORPH
біржақты	біржақ:ROOT/ты:MORPH
сейілтуіміз	сейіл:ROOT/т:MORPH/у:MORPH/іміз:MORPH
көмегімен	көмег:ROOT/і:MORPH/мен:MORPH
тән	тән:ROOT
Платонның	Платон:ROOT/ның:MORPH
де	де:ROOT
да	да:ROOT
айналысқан	айна:ROOT/лыс:MORPH/қан:MORPH
ақылпарасаттың	ақылпарасат:ROOT/тың:MORPH
атап	ата:ROOT/п:MORPH
жиынтығын	жиын:ROOT/тығ:MORPH/ын:MORPH
толысқан	тол:ROOT/ыс:MORPH/қан:MORPH
дүниеге	дүние:ROOT/ге:MORPH
Әйтсе	Әйт:ROOT/се:MORPH
деп	де:ROOT/п:MORPH
жақсырақ	жақсы:ROOT/рақ:MORPH
өріліп	өр:ROOT/іл:MORPH/іп:MORPH
Пайымның	Пайым:ROOT/ның:MORPH
ақиқатқа	ақиқат:ROOT/қа:MORPH
философияға	философия:ROOT/ға:MORPH
өздерінің	өздер:ROOT/і:MORPH/нің:MORPH
қалыптастыра	қалып:ROOT/тас:MORPH/тыр:MORPH/а:MORPH
Соңында	Соң:ROOT/ы:MORPH/н:MORPH/да:MORPH
емес	е:ROOT/мес:MORPH
сынға	сын:ROOT/ға:MORPH
махаббат	махаббат:ROOT
болады	бол:ROOT/а:MORPH/ды:MORPH
мен	мен:ROOT
әдемі	әдемі:ROOT
философиялық	философия:ROOT/лық:MORPH
еш	еш:ROOT
сараптамалық	сарап:ROOT/тама:MORPH/лық:MORPH
екі	екі:ROOT
өзөздеріне	өзөз:ROOT/дер:MORPH/і:MORPH/не:MORPH
болуы	бол:ROOT/у:MORPH/ы:MORPH
қарсы	қарсы:ROOT
ақиқат	ақиқат:ROOT
деп	де:ROOT/п:MORPH
үзінділерді	үзін:ROOT/ді:MORPH/лер:MORPH/ді:MORPH
дәрігерлік	дәрі:ROOT/гер:MORPH/лік:MORPH
Сол	Сол:ROOT
алыс	алыс:ROOT
мен	мен:ROOT
оңдырмай	оң:ROOT/дыр:MORPH/ма:MORPH/й:MORPH
пайымын	пайым:ROOT/ы:MORPH/н:MORPH
әрқайсысы	әр:ROOT/қайсы:MORPH/сы:MORPH
да	да:ROOT
диалог	диалог:ROOT
анықтауымыз	анық:ROOT/та:MORPH/у:MORPH/ымыз:MORPH
жер	жер:ROOT
оқыды	оқы:ROOT/ды:MORPH
құтқаратын	құтқар:ROOT/атын:MORPH
жариялауда	жария:ROOT/ла:MORPH/у:MORPH/да:MORPH
гиппондық	гиппон:ROOT/дық:MORPH
жібереді	жібер:ROOT/е:MORPH/ді:MORPH
үңгірдің	үңгір:ROOT/дің:MORPH
арқауындағы	арқау:ROOT/ын:MORPH/да:MORPH/ғы:MORPH
да	да:ROOT
нығайта	нығай:ROOT/т:MORPH/а:MORPH
қарымқатынаста	қарымқатынас:ROOT/та:MORPH
жеткізу	жет:ROOT/кіз:MORPH/у:MORPH
Біз	Біз:ROOT
гөрі	гөрі:ROOT
әртүрлі	әр:ROOT/түрлі:MORPH
диалогқа	диалог:ROOT/қа:MORPH
еркіндікке	еркіндік:ROOT/ке:MORPH
майевтиканың	майевтика:ROOT/ның:MORPH
берік	берік:ROOT
дейінгі	дейін:ROOT/гі:MORPH
қайтыс	қайтыс:ROOT
Платонның	Платон:ROOT/ның:MORPH
түсіреді	түс:ROOT/ір:MORPH/еді:MORPH
әңгіме	әңгіме:ROOT
Женевьева	Женевьева:ROOT
Локк	Локк:ROOT
ғана	ғана:ROOT
анық	анық:ROOT
Масайраған	Масайра:ROOT/ған:MORPH
ұғымды	ұғым:ROOT/ды:MORPH
нақ	нақ:ROOT
күш	күш:ROOT
бойынша	бойын:ROOT/ша:MORPH
атанды	ата:ROOT/н:MORPH/ды:MORPH
өзекті	өзек:ROOT/ті:MORPH
болып	бол:ROOT/ып:MORPH
идеалға	идеал:ROOT/ға:MORPH
Платон	Платон:ROOT
дәл	дәл:ROOT
қонақтары	қонақ:ROOT/тар:MORPH/ы:MORPH
саясат	саясат:ROOT
Толғаныстарда	Толғаныс:ROOT/тар:MORPH/да:MORPH
оқырманның	оқыр:ROOT/ман:MORPH/ның:MORPH
Гоббс	Гоббс:ROOT
көтерілуге	көтер:ROOT/іл:MORPH/у:MORPH/ге:MORPH
мен	мен:ROOT
гомосексуалдықтың	гомосексуал:ROOT/дық:MORPH/тың:MORPH
абыз	абыз:ROOT
Мемлекетте	Мемлекет:ROOT/те:MORPH
органикалық	органика:ROOT/лық:MORPH
ол	ол:ROOT
айтсақ	айт:ROOT/са:MORPH/қ:MORPH
бастайсыз	баста:ROOT/й:MORPH/сыз:MORPH
білімге	бі:ROOT/лім:MORPH/ге:MORPH
өмірге	өмір:ROOT/ге:MORPH
көп	көп:ROOT
та	та:ROOT
қарекет	қарекет:ROOT
пайымдардың	пайым:ROOT/дар:MORPH/дың:MORPH
қызметіне	қызмет:ROOT/і:MORPH/не:MORPH
болжамды	болжам:ROOT/ды:MORPH
етемін	ет:ROOT/е:MORPH/мін:MORPH
Ол	Ол:ROOT
беруді	бер:ROOT/у:MORPH/ді:MORPH
келген	кел:ROOT/ген:MORPH
тойтарыс	тойтарыс:ROOT
келмейді	кел:ROOT/ме:MORPH/й:MORPH/ді:MORPH
тәлімі	тәлім:ROOT/і:MORPH
ұстанымының	ұстаным:ROOT/ы:MORPH/ның:MORPH
Қала	Қала:ROOT
ретінде	рет:ROOT/і:MORPH/н:MORPH/де:MORPH
ма	ма:ROOT
Философия	Философия:ROOT
бір	бір:ROOT
деген	де:ROOT/ген:MORPH
дүние	дүние:ROOT
дәуірінің	дәуір:ROOT/і:MORPH/нің:MORPH
ақылшыұстаздың	ақыл:ROOT/шыұстаз:MORPH/дың:MORPH
досы	дос:ROOT/ы:MORPH
бұл	бұл:ROOT
онда	он:ROOT/да:MORPH
жақындаудың	жақын:ROOT/да:MORPH/у:MORPH/дың:MORPH
Метеорларда	Метеор:ROOT/ла:MORPH/рда:MORPH
сөйлеген	сөйле:ROOT/ген:MORPH
түріне	түр:ROOT/і:MORPH/не:MORPH
жалпыға	жалпы:ROOT/ға:MORPH
еді	е:ROOT/ді:MORPH
және	және:ROOT
осы	осы:ROOT
ақиқатқа	ақиқат:ROOT/қа:MORPH
болады	бол:ROOT/а:MORPH/ды:MORPH
дамытуға	дамыт:ROOT/у:MORPH/ға:MORPH
жақсы	жақсы:ROOT
нағыз	нағыз:ROOT
жылдар	жыл:ROOT/дар:MORPH
күмәнмен	күмән:ROOT/мен:MORPH
Кейінірек	Кейін:ROOT/ірек:MORPH
құрылымға	құр:ROOT/ыл:MORPH/ым:MORPH/ға:MORPH
тұжырымдаманы	тұжырым:ROOT/дама:MORPH/ны:MORPH
Философтан	Философ:ROOT/тан:MORPH
кемеліне	кемел:ROOT/і:MORPH/не:MORPH
мәліметтердің	мәлімет:ROOT/тер:MORPH/дің:MORPH
берген	бер:ROOT/ген:MORPH
әпсананы	әпсана:ROOT/ны:MORPH
басқару	басқар:ROOT/у:MORPH
ізгіліктердің	ізгі:ROOT/лік:MORPH/тер:MORPH/дің:MORPH
мәтіндердің	мәтін:ROOT/дер:MORPH/дің:MORPH
сөздерінің	сөз:ROOT/дер:MORPH/і:MORPH/нің:MORPH
де	де:ROOT
ұғынған	ұғ:ROOT/ын:MORPH/ған:MORPH
сезінуге	сез:ROOT/ін:MORPH/у:MORPH/ге:MORPH
ажалды	ажал:ROOT/ды:MORPH
киліккен	килік:ROOT/кен:MORPH
резиденті	резидент:ROOT/і:MORPH
соң	соң:ROOT
келтірген	келтір:ROOT/ген:MORPH
Аристофанды	Аристофан:ROOT/ды:MORPH
түсіндірді	түсін:ROOT/дір:MORPH/ді:MORPH
ғана	ғана:ROOT
шындап	шын:ROOT/да:MORPH/п:MORPH
және	және:ROOT
педантты	педант:ROOT/ты:MORPH
көтерсе	көтер:ROOT/се:MORPH
қозғалыс	қозғалыс:ROOT
биік	биік:ROOT
тұрғыдан	тұрғы:ROOT/дан:MORPH
әсіре	әсіре:ROOT
пайымдарды	пайым:ROOT/дар:MORPH/ды:MORPH
мәселелермен	мәселе:ROOT/лер:MORPH/мен:MORPH
махаббатқа	махаббат:ROOT/қа:MORPH
құштарлық	құштар:ROOT/лық:MORPH
сөздерінде	сөз:ROOT/дер:MORPH/і:MORPH/нде:MORPH
мәселесімен	мәселе:ROOT/сі:MORPH/мен:MORPH
Қарапайым	Қарапайым:ROOT
бұрып	бұр:ROOT/ып:MORPH
балгер	бал:ROOT/гер:MORPH
қызықтыра	қызық:ROOT/тыр:MORPH/а:MORPH
аудиторияға	аудитория:ROOT/ға:MORPH
философының	философ:ROOT/ы:MORPH/ның:MORPH
тәжірибе	тәжірибе:ROOT
басқа	басқа:ROOT
теңеледі	теңел:ROOT/е:MORPH/ді:MORPH
келуіне	кел:ROOT/у:MORPH/і:MORPH/не:MORPH
жалпыға	жалпы:ROOT/ға:MORPH
трагедия	трагедия:ROOT
ескерілмеген	ескер:ROOT/іл:MORPH/ме:MORPH/ген:MORPH
де	де:ROOT
ығыстырып	ығыс:ROOT/тыр:MORPH/ып:MORPH
нұсқасы	нұсқа:ROOT/сы:MORPH
бөлінген	бөл:ROOT/ін:MORPH/ген:MORPH
ақылпарасаты	ақылпарасат:ROOT/ы:MORPH
келеді	кел:ROOT/е:MORPH/ді:MORPH
та	та:ROOT
түрінде	түр:ROOT/і:MORPH/н:MORPH/де:MORPH
бізге	біз:ROOT/ге:MORPH
үңгір	үңгір:ROOT
ұмтылысқа	ұмтылыс:ROOT/қа:MORPH
көрсету	көр:ROOT/се:MORPH/т:MORPH/у:MORPH
қалмай	қал:ROOT/ма:MORPH/й:MORPH
Математик	Математик:ROOT
тылсым	тыл:ROOT/сым:MORPH
әпсана	әпсана:ROOT
есептелген	есеп:ROOT/те:MORPH/л:MORPH/ген:MORPH
және	және:ROOT
арналған	арна:ROOT/л:MORPH/ған:MORPH
сияқты	сияқты:ROOT
есептейді	есеп:ROOT/те:MORPH/й:MORPH/ді:MORPH
Алайда	Алайда:ROOT
саяси	саяс:ROOT/и:MORPH
латынданған	латын:ROOT/дан:MORPH/ған:MORPH
сұхбаттасушылардың	сұхбат:ROOT/тас:MORPH/у:MORPH/шы:MORPH/лар:MORPH/дың:MORPH
өзін	өз:ROOT/ін:MORPH
әркез	әркез:ROOT
өзінің	өз:ROOT/і:MORPH/нің:MORPH
оның	о:ROOT/ның:MORPH
сарындағы	сарын:ROOT/да:MORPH/ғы:MORPH
тыныштықты	тыныш:ROOT/тық:MORPH/ты:MORPH
Бұл	Бұл:ROOT
болмаса	бол:ROOT/ма:MORPH/са:MORPH
ақиқат	ақиқат:ROOT
қорытындылар	қорытынды:ROOT/лар:MORPH
таңдаған	таң:ROOT/да:MORPH/ған:MORPH
нәрсеге	нәрсе:ROOT/ге:MORPH
жоғары	жоғары:ROOT
әрқашан	әрқашан:ROOT
жаппай	жап:ROOT/па:MORPH/й:MORPH
Уордтың	Уорд:ROOT/тың:MORPH
қоймаған	қой:ROOT/ма:MORPH/ған:MORPH
философияға	философия:ROOT/ға:MORPH
ұлағатты	ұлағат:ROOT/ты:MORPH
мағынасында	мағына:ROOT/сы:MORPH/н:MORPH/да:MORPH
Осы	Осы:ROOT
оған	о:ROOT/ған:MORPH
нақыл	нақыл:ROOT
өз	өз:ROOT
қалай	қалай:ROOT
кезде	кез:ROOT/де:MORPH
көзқарастарды	көз:ROOT/қарас:MORPH/тар:MORPH/ды:MORPH
болудың	бол:ROOT/у:MORPH/дың:MORPH
болады	бол:ROOT/а:MORPH/ды:MORPH
құмарлыққа	құмар:ROOT/лық:MORPH/қа:MORPH
және	және:ROOT
сыртқы	сырт:ROOT/қы:MORPH
Адамның	Адам:ROOT/ның:MORPH
осы	осы:ROOT
тұрғысынан	тұр:ROOT/ғы:MORPH/сы:MORPH/нан:MORPH
қауіп	қауіп:ROOT
Ал	Ал:ROOT
ие	ие:ROOT
Бұл	Бұл:ROOT
заманынан	заман:ROOT/ы:MORPH/нан:MORPH
Ол	Ол:ROOT
да	да:ROOT
Сондықтан	Сондықтан:ROOT
Сонымен	Со:ROOT/ны:MORPH/мен:MORPH
ерік	ерік:ROOT
Платонның	Платон:ROOT/ның:MORPH
бөлімдеріне	бөл:ROOT/ім:MORPH/дер:MORPH/і:MORPH/не:MORPH
емес	е:ROOT/мес:MORPH
тұтас	тұтас:ROOT
де	де:ROOT
шығарады	шығар:ROOT/а:MORPH/ды:MORPH
айтсақ	айт:ROOT/са:MORPH/қ:MORPH
жарық	жарық:ROOT
және	және:ROOT
өзге	өз:ROOT/ге:MORPH
қарапайым	қарапайым:ROOT
Логостың	Логос:ROOT/тың:MORPH
саяси	саяс:ROOT/и:MORPH
қатар	қатар:ROOT
жинаған	жина:ROOT/ған:MORPH
көмектесу	көмек:ROOT/тес:MORPH/у:MORPH
бой	бой:ROOT
бірбіріне	бірбір:ROOT/і:MORPH/не:MORPH
жатқан	жат:ROOT/қан:MORPH
наразылық	наразы:ROOT/лық:MORPH
шығуға	шығ:ROOT/у:MORPH/ға:MORPH
тән	тән:ROOT
осы	осы:ROOT
жауап	жауап:ROOT
келгенде	кел:ROOT/ген:MORPH/де:MORPH
тобына	тоб:ROOT/ы:MORPH/на:MORPH
қамалған	қамал:ROOT/ған:MORPH
именбей	имен:ROOT/бе:MORPH/й:MORPH
сұлулыққа	сұлу:ROOT/лық:MORPH/қа:MORPH
мақсаты	мақсат:ROOT/ы:MORPH
әділдігі	әділ:ROOT/діг:MORPH/і:MORPH
Тарихтан	Тарих:ROOT/тан:MORPH
Кіші	Кіші:ROOT
бөлігін	бөліг:ROOT/і:MORPH/н:MORPH
мүсінінің	мүсін:ROOT/і:MORPH/нің:MORPH
саяси	саяс:ROOT/и:MORPH
және	және:ROOT
үздіксіз	үздік:ROOT/сіз:MORPH
емес	е:ROOT/ме:MORPH/с:MORPH
һәм	һәм:ROOT
ойшыл	ой:ROOT/шыл:MORPH
Cogito	Cogito:ROOT
әртүрлі	әртүрлі:ROOT
жазылған	жаз:ROOT/ыл:MORPH/ған:MORPH
әрі	әрі:ROOT
заманның	заман:ROOT/ның:MORPH
канцлер	канцлер:ROOT
да	да:ROOT
елде	ел:ROOT/де:MORPH
әрқашан	әрқашан:ROOT
философты	философ:ROOT/ты:MORPH
Филалет	Филалет:ROOT
болатын	бол:ROOT/атын:MORPH
биік	биік:ROOT
бұл	бұл:ROOT
күреседі	күрес:ROOT/е:MORPH/ді:MORPH
философиялық	философия:ROOT/лық:MORPH
жағдайында	жағдай:ROOT/ы:MORPH/н:MORPH/да:MORPH
алдынан	ал:ROOT/ды:MORPH/нан:MORPH
тәжірибе	тәжірибе:ROOT
алдырмай	алдыр:ROOT/ма:MORPH/й:MORPH
Олар	О:ROOT/лар:MORPH
қолайлы	қолай:ROOT/лы:MORPH
екінші	ек:ROOT/інші:MORPH
бағынышты	бағ:ROOT/ыныш:MORPH/ты:MORPH
қызмет	қызмет:ROOT
арттыра	арт:ROOT/тыр:MORPH/а:MORPH
өмірі	өмір:ROOT/і:MORPH
жауап	жауап:ROOT
келген	кел:ROOT/ген:MORPH
сұлулық	сұлу:ROOT/лық:MORPH
екінші	ек:ROOT/інші:MORPH
қасында	қас:ROOT/ы:MORPH/н:MORPH/да:MORPH
аулақ	аулақ:ROOT
олардың	о:ROOT/лар:MORPH/дың:MORPH
бұл	бұл:ROOT
саясат	саясат:ROOT
өрбіген	өрбі:ROOT/ген:MORPH
кітабын	кітаб:ROOT/ы:MORPH/н:MORPH
Роберт	Роберт:ROOT
соңғы	соң:ROOT/ғы:MORPH
кемшілігі	кем:ROOT/шіліг:MORPH/і:MORPH
көрсетіледі	көр:ROOT/се:MORPH/т:MORPH/іл:MORPH/е:MORPH/ді:MORPH
әуенге	әуен:ROOT/ге:MORPH
дамуы	дам:ROOT/у:MORPH/ы:MORPH
Өйткені	Өйткені:ROOT
Шектен	Шек:ROOT/тен:MORPH
бірінбірі	бір:ROOT/інбірі:MORPH
тілін	тіл:ROOT/і:MORPH/н:MORPH
интернеті	интернет:ROOT/і:MORPH
оларға	о:ROOT/лар:MORPH/ға:MORPH
қарай	қарай:ROOT
айналысу	айналыс:ROOT/у:MORPH
кез	кез:ROOT
француз	француз:ROOT
туралы	туралы:ROOT
қалалар	қала:ROOT/лар:MORPH
бірігу	біріг:ROOT/у:MORPH
тартады	тарт:ROOT/а:MORPH/ды:MORPH
авторы	автор:ROOT/ы:MORPH
қайғылы	қайғы:ROOT/лы:MORPH
ұсынады	ұсын:ROOT/а:MORPH/ды:MORPH
топшылауға	топшы:ROOT/ла:MORPH/у:MORPH/ға:MORPH
жалқы	жалқы:ROOT
кеткен	кет:ROOT/кен:MORPH
бірге	бірге:ROOT
Біртұтас	Бір:ROOT/тұтас:MORPH
сөзі	сөз:ROOT/і:MORPH
және	және:ROOT
болғаннан	бол:ROOT/ған:MORPH/нан:MORPH
қосылады	қос:ROOT/ыл:MORPH/а:MORPH/ды:MORPH
тұтастыққа	тұтас:ROOT/тық:MORPH/қа:MORPH
іштей	іш:ROOT/тей:MORPH
мұны	мұ:ROOT/ны:MORPH
да	да:ROOT
Евангелос	Евангелос:ROOT
кетпейміз	кет:ROOT/пе:MORPH/й:MORPH/міз:MORPH
керек	керек:ROOT
рухтың	рух:ROOT/тың:MORPH
Картезий	Картезий:ROOT
әбден	әбден:ROOT
алдыңғыларды	алды:ROOT/ң:MORPH/ғы:MORPH/лар:MORPH/ды:MORPH
олардың	о:ROOT/лар:MORPH/дың:MORPH
Агафонға	Агафон:ROOT/ға:MORPH
өзіне	өз:ROOT/і:MORPH/не:MORPH
бір	бір:ROOT
дейін	дейін:ROOT
кіршіксіз	кіршік:ROOT/сіз:MORPH
жоқ	жоқ:ROOT
сөйлегенде	сөйле:ROOT/ген:MORPH/де:MORPH
Дегенмен	Деген:ROOT/мен:MORPH
әдісті	әдіс:ROOT/ті:MORPH
келіп	кел:ROOT/іп:MORPH
ұлы	ұлы:ROOT
тұтас	тұтас:ROOT
ол	ол:ROOT
және	және:ROOT
демек	де:ROOT/ме:MORPH/к:MORPH
негізгі	негіз:ROOT/гі:MORPH
жазады	жаз:ROOT/а:MORPH/ды:MORPH
зор	зор:ROOT
тұрақсыз	тұрақ:ROOT/сыз:MORPH
беру	бер:ROOT/у:MORPH
жасырынған	жасырын:ROOT/ған:MORPH
болса	бол:ROOT/са:MORPH
достарын	дос:ROOT/тар:MORPH/ы:MORPH/н:MORPH
пайдалануға	пайдалан:ROOT/у:MORPH/ға:MORPH
етеді	ет:ROOT/е:MORPH/ді:MORPH
бар	бар:ROOT
Ол	Ол:ROOT
ретте	рет:ROOT/те:MORPH
үшін	үшін:ROOT
баяндайды	баянда:ROOT/й:MORPH/ды:MORPH
болған	бол:ROOT/ған:MORPH
тұрғысындағы	тұрғы:ROOT/сы:MORPH/н:MORPH/да:MORPH/ғы:MORPH
үшін	үшін:ROOT
тастайды	таста:ROOT/й:MORPH/ды:MORPH
құмарлық	құмар:ROOT/лық:MORPH
негізінде	негіз:ROOT/і:MORPH/н:MORPH/де:MORPH
әңгіме	әңгіме:ROOT
ғой	ғой:ROOT
сауалды	сауал:ROOT/ды:MORPH
Біз	Біз:ROOT
қарсы	қарсы:ROOT
тырысады	тырыс:ROOT/а:MORPH/ды:MORPH
арнағысы	арна:ROOT/ғы:MORPH/сы:MORPH
кіндік	кіндік:ROOT
Ол	Ол:ROOT
береді	бер:ROOT/е:MORPH/ді:MORPH
қоршаған	қорша:ROOT/ған:MORPH
атап	ата:ROOT/п:MORPH
көтеріп	көтер:ROOT/іп:MORPH
алғанын	ал:ROOT/ған:MORPH/ы:MORPH/н:MORPH
әдістерімен	әдіс:ROOT/тер:MORPH/і:MORPH/мен:MORPH
алдын	алдын:ROOT
еске	ес:ROOT/ке:MORPH
адамдардың	адам:ROOT/дар:MORPH/дың:MORPH
да	да:ROOT
қатынасын	қатынас:ROOT/ы:MORPH/н:MORPH
болатын	бол:ROOT/атын:MORPH
тұра	тұр:ROOT/а:MORPH
тұрғыдан	тұрғы:ROOT/дан:MORPH
Мутсопулостың	Мутсопулостың:ROOT
тиіс	тиіс:ROOT
бір	бір:ROOT
данышпандар	данышпан:ROOT/дар:MORPH
ерекшеленеді	ерекше:ROOT/лен:MORPH/е:MORPH/ді:MORPH
ұсқынсыз	ұсқын:ROOT/сыз:MORPH
метафоралық	метафора:ROOT/лық:MORPH
аралық	ара:ROOT/лық:MORPH
жолын	жол:ROOT/ы:MORPH/н:MORPH
парасаттылықпен	парасат:ROOT/ты:MORPH/лық:MORPH/пен:MORPH
ие	ие:ROOT
топ	топ:ROOT
жүргізіп	жүр:ROOT/гіз:MORPH/іп:MORPH
тұрғыда	тұрғы:ROOT/да:MORPH
сөз	сөз:ROOT
кейіпкер	кейіп:ROOT/кер:MORPH
бәрінен	бәрі:ROOT/нен:MORPH
ықыласы	ықылас:ROOT/ы:MORPH
бейнесін	бейне:ROOT/сі:MORPH/н:MORPH
екені	е:ROOT/кен:MORPH/і:MORPH
туралы	туралы:ROOT
тілінде	тіл:ROOT/і:MORPH/н:MORPH/де:MORPH
санқилы	санқи:ROOT/лы:MORPH
секілді	секілді:ROOT
үңгірден	үңгір:ROOT/ден:MORPH
мәнерімен	мәнер:ROOT/і:MORPH/мен:MORPH
заттар	зат:ROOT/тар:MORPH
көріпбіле	көр:ROOT/іпбіл:MORPH/е:MORPH
адамның	адам:ROOT/ның:MORPH
басқа	басқа:ROOT
пері	пері:ROOT
тек	тек:ROOT
Біздің	Біз:ROOT/дің:MORPH
II	II:ROOT
қателесеміз	қате:ROOT/лес:MORPH/е:MORPH/міз:MORPH
атқарған	атқар:ROOT/ған:MORPH
махаббаттың	махаббат:ROOT/тың:MORPH
талай	талай:ROOT
тиіс	тиіс:ROOT
көрсетуімен	көр:ROOT/се:MORPH/т:MORPH/у:MORPH/і:MORPH/мен:MORPH
және	және:ROOT
тырыспайды	тырыс:ROOT/па:MORPH/й:MORPH/ды:MORPH
ұластырады	ұлас:ROOT/тыр:MORPH/а:MORPH/ды:MORPH
қарайтынын	қара:ROOT/йтын:MORPH/ы:MORPH/н:MORPH
қызықтырған	қызық:ROOT/тыр:MORPH/ған:MORPH
келіседі	келіс:ROOT/е:MORPH/ді:MORPH
бұл	бұл:ROOT
жоғары	жоғары:ROOT
Кейбір	Кейбір:ROOT
өзіне	өз:ROOT/і:MORPH/не:MORPH
үш	үш:ROOT
заңмен	заң:ROOT/мен:MORPH
Пения	Пения:ROOT
дәуірге	дәуі:ROOT/рге:MORPH
шешенді	шешен:ROOT/ді:MORPH
анықтауға	анық:ROOT/та:MORPH/у:MORPH/ға:MORPH
Оксфордта	Оксфорд:ROOT/та:MORPH
сөнгенге	сөн:ROOT/ген:MORPH/ге:MORPH
құқықтарынан	құқық:ROOT/тар:MORPH/ы:MORPH/нан:MORPH
тұста	тұс:ROOT/та:MORPH
шектеліп	шек:ROOT/те:MORPH/л:MORPH/іп:MORPH
болса	бол:ROOT/са:MORPH
болбыр	болбыр:ROOT
сәтте	сәт:ROOT/те:MORPH
өзіндік	өзін:ROOT/дік:MORPH
тырысады	тырыс:ROOT/а:MORPH/ды:MORPH
жүйесінің	жүйе:ROOT/сі:MORPH/нің:MORPH
құдіреттілік	құдірет:ROOT/ті:MORPH/лік:MORPH
үшін	үшін:ROOT
де	де:ROOT
астарлы	астар:ROOT/лы:MORPH
Философ	Философ:ROOT
сонда	сон:ROOT/да:MORPH
жарық	жарық:ROOT
күнге	күн:ROOT/ге:MORPH
Осыған	Осы:ROOT/ған:MORPH
ақынды	ақын:ROOT/ды:MORPH
тілдерінде	тіл:ROOT/дер:MORPH/і:MORPH/н:MORPH/де:MORPH
туралы	туралы:ROOT
сөздің	сөз:ROOT/дің:MORPH
құрылуы	құр:ROOT/ыл:MORPH/у:MORPH/ы:MORPH
рақымсыз	рақым:ROOT/сыз:MORPH
Аристофанға	Аристофан:ROOT/ға:MORPH
бірнеше	бірнеше:ROOT
Пьер	Пьер:ROOT
ишарамен	ишара:ROOT/мен:MORPH
Сондықтан	Сондықтан:ROOT
замандастарының	заман:ROOT/дас:MORPH/тар:MORPH/ы:MORPH/ның:MORPH
танымның	тан:ROOT/ым:MORPH/ның:MORPH
бойынша	бойын:ROOT/ша:MORPH
анықтауға	анықт:ROOT/а:MORPH/у:MORPH/ға:MORPH
әрі	әрі:ROOT
тартады	тарт:ROOT/а:MORPH/ды:MORPH
ғылым	ғылым:ROOT
рет	рет:ROOT
жеке	жеке:ROOT
ұйыта	ұйыт:ROOT/а:MORPH
сайлау	сайла:ROOT/у:MORPH
мәңгілікпен	мәңгі:ROOT/лік:MORPH/пен:MORPH
қателік	қате:ROOT/лік:MORPH
айтқандары	айт:ROOT/қан:MORPH/дар:MORPH/ы:MORPH
Сөз	Сөз:ROOT
кітабы	кітаб:ROOT/ы:MORPH
басқа	басқа:ROOT
Францияға	Франция:ROOT/ға:MORPH
Э	Э:ROOT
лорд	лорд:ROOT
поэзияға	поэзия:ROOT/ға:MORPH
өзімді	өз:ROOT/ім:MORPH/ді:MORPH
түріне	түр:ROOT/і:MORPH/не:MORPH
Әдіс	Әдіс:ROOT
тән	тән:ROOT
туралы	туралы:ROOT
ғалымдары	ғалым:ROOT/дар:MORPH/ы:MORPH
өз	өз:ROOT
деп	деп:ROOT
болып	бол:ROOT/ып:MORPH
Симпозиумнан	Симпозиум:ROOT/нан:MORPH
әділдік	әділ:ROOT/дік:MORPH
мұндай	мұн:ROOT/дай:MORPH
саңылаулардан	саңылау:ROOT/лар:MORPH/дан:MORPH
ойдан	ой:ROOT/дан:MORPH
екіге	екі:ROOT/ге:MORPH
бұл	бұл:ROOT
тіпті	тіпті:ROOT
да	да:ROOT
жыныстық	жыныс:ROOT/тық:MORPH
деген	де:ROOT/ген:MORPH
ретіндегі	рет:ROOT/ін:MORPH/дегі:MORPH
дастарқанына	дастарқан:ROOT/ы:MORPH/на:MORPH
ғана	ғана:ROOT
пікірлердің	пікір:ROOT/лер:MORPH/дің:MORPH
француз	француз:ROOT
Платон	Платон:ROOT
Алкивиад	Алкивиад:ROOT
орынға	орын:ROOT/ға:MORPH
логиканы	логикан:ROOT/ы:MORPH
жағдайдың	жағдай:ROOT/дың:MORPH
масқарампаз	масқарам:ROOT/паз:MORPH
құрылуының	құр:ROOT/ыл:MORPH/у:MORPH/ы:MORPH/ның:MORPH
туралы	туралы:ROOT
жақтап	жақта:ROOT/п:MORPH
авторлар	автор:ROOT/лар:MORPH
Сократ	Сократ:ROOT
саналмайды	санал:ROOT/ма:MORPH/й:MORPH/ды:MORPH
пайда	пайда:ROOT
өкілі	өкіл:ROOT/і:MORPH
Дионисий	Дионисий:ROOT
объектісі	объекті:ROOT/сі:MORPH
шыңдалған	шыңд:ROOT/ал:MORPH/ған:MORPH
лайық	лайық:ROOT
есепке	есеп:ROOT/ке:MORPH
көзқарасын	көз:ROOT/қарас:MORPH/ы:MORPH/н:MORPH
деген	де:ROOT/ген:MORPH
Осы	Осы:ROOT
теориясы	теория:ROOT/сы:MORPH
тек	тек:ROOT
ғалымның	ғалым:ROOT/ның:MORPH
тәлкек	тәлкек:ROOT
шығармаларын	шығ:ROOT/ар:MORPH/ма:MORPH/лар:MORPH/ы:MORPH/н:MORPH
шын	шын:ROOT
барын	бар:ROOT/ы:MORPH/н:MORPH
шынайы	шынайы:ROOT
оған	о:ROOT/ған:MORPH
суық	суық:ROOT
ушығып	ушығ:ROOT/ып:MORPH
тәсілі	тәсіл:ROOT/і:MORPH
ұстаған	ұста:ROOT/ған:MORPH
құдіреттілігі	құдірет:ROOT/ті:MORPH/ліг:MORPH/і:MORPH
жеңілдетеді	жеңіл:ROOT/де:MORPH/т:MORPH/е:MORPH/ді:MORPH
Ал	Ал:ROOT
Соғыстарды	Соғыс:ROOT/тар:MORPH/ды:MORPH
әңгімені	әңгіме:ROOT/ні:MORPH
өзіне	өз:ROOT/і:MORPH/не:MORPH
білдіреді	біл:ROOT/дір:MORPH/е:MORPH/ді:MORPH
ауысады	ауыс:ROOT/а:MORPH/ды:MORPH
сезімінен	сез:ROOT/ім:MORPH/і:MORPH/нен:MORPH
қажеттілігі	қажет:ROOT/ті:MORPH/ліг:MORPH/і:MORPH
кезеңіндегі	кезең:ROOT/і:MORPH/н:MORPH/де:MORPH/гі:MORPH
философияның	философия:ROOT/ның:MORPH
әдісі	әдіс:ROOT/і:MORPH
түрлі	түр:ROOT/лі:MORPH
көңілін	көңіл:ROOT/ін:MORPH
келіп	кел:ROOT/іп:MORPH
өзінің	өз:ROOT/і:MORPH/нің:MORPH
бейнелейді	бейне:ROOT/ле:MORPH/й:MORPH/ді:MORPH
тез	тез:ROOT
бізге	біз:ROOT/ге:MORPH
Игіліктің	Игілік:ROOT/тің:MORPH
береді	бер:ROOT/е:MORPH/ді:MORPH
пайымның	пайым:ROOT/ның:MORPH
өзінің	өз:ROOT/і:MORPH/нің:MORPH
жазады	жаз:ROOT/а:MORPH/ды:MORPH
келсек	кел:ROOT/се:MORPH/к:MORPH
алғанда	ал:ROOT/ған:MORPH/да:MORPH
сократтық	сократ:ROOT/тық:MORPH
Геометрия	Геометрия:ROOT
диалектикасы	диалектика:ROOT/сы:MORPH
созылысты	созыл:ROOT/ыс:MORPH/ты:MORPH
Диалектика	Диалектика:ROOT
айқын	айқын:ROOT
бас	бас:ROOT
Платонның	Платон:ROOT/ның:MORPH
анықтамаларды	анық:ROOT/тама:MORPH/лар:MORPH/ды:MORPH
шын	шын:ROOT
алдырады	ал:ROOT/дыр:MORPH/а:MORPH/ды:MORPH
болар	бол:ROOT/ар:MORPH
өзгеріп	өзгер:ROOT/іп:MORPH
танымал	таным:ROOT/ал:MORPH
бұл	бұл:ROOT
махаббаттың	махаббат:ROOT/тың:MORPH
болмыстардың	бол:ROOT/мыс:MORPH/тар:MORPH/дың:MORPH
әдетқылықтарының	әдетқылық:ROOT/тар:MORPH/ы:MORPH/ның:MORPH
болса	бол:ROOT/са:MORPH
үйлесім	үйлес:ROOT/ім:MORPH
Сократ	Сократ:ROOT
да	да:ROOT
құрылымы	құр:ROOT/ыл:MORPH/ым:MORPH/ы:MORPH
өзінше	өзін:ROOT/ше:MORPH
ішіпжем	іш:ROOT/іпжем:MORPH
сол	сол:ROOT
тысқары	тысқары:ROOT
Сократтық	Сократ:ROOT/тық:MORPH
келген	кел:ROOT/ген:MORPH
Шын	Шын:ROOT
баяндау	баян:ROOT/да:MORPH/у:MORPH
және	және:ROOT
оның	о:ROOT/ның:MORPH
яғни	яғни:ROOT
бозбала	боз:ROOT/бала:MORPH
мәселелері	мәселе:ROOT/лер:MORPH/і:MORPH
аса	аса:ROOT
айтады	айт:ROOT/а:MORPH/ды:MORPH
ауды	ау:ROOT/ды:MORPH
терең	терең:ROOT
органикалық	органика:ROOT/лық:MORPH
махаббат	махаббат:ROOT
көреді	көр:ROOT/е:MORPH/ді:MORPH
біріктіреді	бір:ROOT/ік:MORPH/тір:MORPH/е:MORPH/ді:MORPH
бас	бас:ROOT
өкілі	өкіл:ROOT/і:MORPH
ред	ред:ROOT
нәтижесіз	нәтиже:ROOT/сіз:MORPH
әрқайсысы	әрқайсы:ROOT/сы:MORPH
бар	бар:ROOT
Латын	Латын:ROOT
екінші	ек:ROOT/інші:MORPH
тұсының	тұс:ROOT/ы:MORPH/ның:MORPH
көмегімен	көмег:ROOT/і:MORPH/мен:MORPH
нақты	нақты:ROOT
өзінің	өз:ROOT/і:MORPH/нің:MORPH
шығатынын	шығ:ROOT/атын:MORPH/ы:MORPH/н:MORPH
арифметикалық	арифметика:ROOT/лық:MORPH
Ғылымды	Ғылым:ROOT/ды:MORPH
көрсеткен	көр:ROOT/се:MORPH/т:MORPH/кен:MORPH
сымбатты	сымбат:ROOT/ты:MORPH
ол	ол:ROOT
кезегі	кезег:ROOT/і:MORPH
мүмкіндік	мүмкін:ROOT/дік:MORPH
осындай	осын:ROOT/дай:MORPH
жолының	жол:ROOT/ы:MORPH/ның:MORPH
метафизикасының	метафизика:ROOT/сы:MORPH/ның:MORPH
жол	жол:ROOT
Эростың	Эрос:ROOT/тың:MORPH
шығармашылық	шығ:ROOT/ар:MORPH/ма:MORPH/шылық:MORPH
бәйгесінде	бәйге:ROOT/сі:MORPH/н:MORPH/де:MORPH
медицинаға	медицина:ROOT/ға:MORPH
өміріміз	өмір:ROOT/і:MORPH/міз:MORPH
жылдар	жыл:ROOT/дар:MORPH
болмауы	бол:ROOT/ма:MORPH/у:MORPH/ы:MORPH
Декарттың	Декарт:ROOT/тың:MORPH
болып	бол:ROOT/ып:MORPH
Ал	Ал:ROOT
жарқын	жарқын:ROOT
бұл	бұл:ROOT
береді	бер:ROOT/е:MORPH/ді:MORPH
Дәрігер	Дәрі:ROOT/гер:MORPH
танытып	таны:ROOT/т:MORPH/ып:MORPH
мәліметі	мәлімет:ROOT/і:MORPH
көрсеткендей	көр:ROOT/сет:MORPH/кен:MORPH/дей:MORPH
окказионализмнің	окказионализм:ROOT/нің:MORPH
кезектесіп	кезек:ROOT/тес:MORPH/іп:MORPH
жаңылдыратын	жаңыл:ROOT/дыр:MORPH/атын:MORPH
даналық	дана:ROOT/лық:MORPH
өзінің	өз:ROOT/і:MORPH/нің:MORPH
жалыққан	жалық:ROOT/қан:MORPH
уәждерді	уәж:ROOT/дер:MORPH/ді:MORPH
идеялар	идея:ROOT/лар:MORPH
кезеңдері	кезең:ROOT/дер:MORPH/і:MORPH
еңбектері	еңбек:ROOT/тер:MORPH/і:MORPH
көпшілік	көп:ROOT/ші:MORPH/лік:MORPH
құрамдас	құрам:ROOT/дас:MORPH
бойы	бой:ROOT/ы:MORPH
көзілдіріктің	көз:ROOT/іл:MORPH/дірік:MORPH/тің:MORPH
кез	кез:ROOT
мансабы	мансаб:ROOT/ы:MORPH
адамдардың	адам:ROOT/дар:MORPH/дың:MORPH
Тән	Тән:ROOT
Оның	О:ROOT/ның:MORPH
келуі	кел:ROOT/у:MORPH/і:MORPH
кемдігі	кемдіг:ROOT/і:MORPH
беру	бер:ROOT/у:MORPH
сөз	сөз:ROOT
амалдары	амал:ROOT/дар:MORPH/ы:MORPH
арналған	арнал:ROOT/ған:MORPH
жыл	жыл:ROOT
көрсету	көр:ROOT/се:MORPH/т:MORPH/у:MORPH
бәрібір	бәрібір:ROOT
сәуегейлер	сәуе:ROOT/гей:MORPH/лер:MORPH
және	және:ROOT
Өйткені	Өйткені:ROOT
ауаны	ауа:ROOT/ны:MORPH
тақырыбына	тақырыб:ROOT/ы:MORPH/на:MORPH
мәнердің	мәнер:ROOT/дің:MORPH
баяндалады	баян:ROOT/да:MORPH/ла:MORPH/ды:MORPH
Саясат	Саясат:ROOT
дегенді	деген:ROOT/ді:MORPH
килігу	киліг:ROOT/у:MORPH
әлі	әлі:ROOT
ұсынған	ұсын:ROOT/ған:MORPH
жалпыдан	жалпы:ROOT/дан:MORPH
Диотимамен	Диотима:ROOT/мен:MORPH
жиналып	жин:ROOT/ал:MORPH/ып:MORPH
Эрос	Эрос:ROOT
қинаған	қина:ROOT/ған:MORPH
шын	шын:ROOT
қарай	қарай:ROOT
ғылымды	ғылым:ROOT/ды:MORPH
метафизика	метафизика:ROOT
жоқ	жоқ:ROOT
қабырғаларына	қабырға:ROOT/лар:MORPH/ы:MORPH/на:MORPH
айта	айт:ROOT/а:MORPH
жатқан	жат:ROOT/қан:MORPH
асқақ	асқақ:ROOT
растайтын	рас:ROOT/та:MORPH/йтын:MORPH
Әйтсе	Әйт:ROOT/се:MORPH
саясат	саясат:ROOT
терең	терең:ROOT
байланысты	байлан:ROOT/ыс:MORPH/ты:MORPH
бізге	біз:ROOT/ге:MORPH
алады	ал:ROOT/а:MORPH/ды:MORPH
Содан	Со:ROOT/дан:MORPH
мәні	мән:ROOT/і:MORPH
cogitoсы	cogitoсы:ROOT
одан	о:ROOT/дан:MORPH
тілге	тіл:ROOT/ге:MORPH
шын	шын:ROOT
ред	ред:ROOT
кітабында	кітаб:ROOT/ы:MORPH/н:MORPH/да:MORPH
бүкпесіз	бүкпе:ROOT/сіз:MORPH
ақиқат	ақиқат:ROOT
емес	е:ROOT/мес:MORPH
сыну	сын:ROOT/у:MORPH
Локк	Локк:ROOT
сенімсіздік	сен:ROOT/ім:MORPH/сіз:MORPH/дік:MORPH
түседі	түс:ROOT/е:MORPH/ді:MORPH
үшін	үшін:ROOT
бөлімдердегі	бөлім:ROOT/дер:MORPH/де:MORPH/гі:MORPH
айтылғандай	айт:ROOT/ыл:MORPH/ған:MORPH/дай:MORPH
адамдарға	адам:ROOT/дар:MORPH/ға:MORPH
білмейді	біл:ROOT/ме:MORPH/й:MORPH/ді:MORPH
басқа	басқа:ROOT
еді	е:ROOT/ді:MORPH
жөн	жөн:ROOT
оралады	орал:ROOT/а:MORPH/ды:MORPH
латын	латын:ROOT
республикалық	республика:ROOT/лық:MORPH
гетеро	гетеро:ROOT
қарағанда	қара:ROOT/ған:MORPH/да:MORPH
көрсетті	көр:ROOT/се:MORPH/т:MORPH/ті:MORPH
Оның	О:ROOT/ның:MORPH
оқығаннан	оқы:ROOT/ған:MORPH/нан:MORPH
әртүрлі	әртүрлі:ROOT
салиқалы	салиқа:ROOT/лы:MORPH
біздің	біз:ROOT/дің:MORPH
Диотиманың	Диотима:ROOT/ның:MORPH
бар	бар:ROOT
мәселесі	мәселе:ROOT/сі:MORPH
Парасаттылық	Парасат:ROOT/ты:MORPH/лық:MORPH
береді	бер:ROOT/е:MORPH/ді:MORPH
Ойға	Ой:ROOT/ға:MORPH
Әдіске	Әдіс:ROOT/ке:MORPH
антропология	антропология:ROOT
философияға	философия:ROOT/ға:MORPH
Ол	Ол:ROOT
ешқашан	еш:ROOT/қашан:MORPH
тіршілікті	тір:ROOT/шілік:MORPH/ті:MORPH
жартысында	жарты:ROOT/сы:MORPH/н:MORPH/да:MORPH
қалмайды	қал:ROOT/ма:MORPH/й:MORPH/ды:MORPH
әсем	әсем:ROOT
екен	е:ROOT/кен:MORPH
пайдалана	пайда:ROOT/лан:MORPH/а:MORPH
Бірақ	Бірақ:ROOT
XII	XII:ROOT
болдырмауға	бол:ROOT/дыр:MORPH/ма:MORPH/у:MORPH/ға:MORPH
қызықтырады	қызық:ROOT/тыр:MORPH/а:MORPH/ды:MORPH
пікірталасты	пікір:ROOT/талас:MORPH/ты:MORPH
мен	мен:ROOT
күнді	күнді:ROOT
мөрді	мөр:ROOT/ді:MORPH
табиғатына	табиғат:ROOT/ы:MORPH/на:MORPH
оның	о:ROOT/ның:MORPH
өзінше	өз:ROOT/ін:MORPH/ше:MORPH
яғни	яғни:ROOT
ақиқаттың	ақиқат:ROOT/тың:MORPH
Құбылыстардың	Құбылыс:ROOT/тар:MORPH/дың:MORPH
мұндай	мұн:ROOT/дай:MORPH
алатын	ал:ROOT/атын:MORPH
пен	пен:ROOT
нәтижесі	нәтиже:ROOT/сі:MORPH
шешендік	шешен:ROOT/дік:MORPH
ашық	ашық:ROOT
табиғи	табиғ:ROOT/и:MORPH
Олар	О:ROOT/лар:MORPH
айтылмаған	айт:ROOT/ыл:MORPH/ма:MORPH/ған:MORPH
жазу	жаз:ROOT/у:MORPH
дүниені	дүние:ROOT/ні:MORPH
құштарлық	құштар:ROOT/лық:MORPH
бейбітшілікке	бейбіт:ROOT/ші:MORPH/лік:MORPH/ке:MORPH
дағдыланған	дағды:ROOT/лан:MORPH/ған:MORPH
алмастыруға	алмас:ROOT/тыр:MORPH/у:MORPH/ға:MORPH
туралы	туралы:ROOT
көреді	көр:ROOT/е:MORPH/ді:MORPH
заманғы	заман:ROOT/ғы:MORPH
ол	ол:ROOT
алдымен	алды:ROOT/мен:MORPH
болмысы	бол:ROOT/мыс:MORPH/ы:MORPH
сезу	сез:ROOT/у:MORPH
өте	өте:ROOT
айтты	айт:ROOT/ты:MORPH
үшін	үшін:ROOT
мен	мен:ROOT
эмоциялы	эмоция:ROOT/лы:MORPH
Әсемдік	Әсем:ROOT/дік:MORPH
түйінін	түйін:ROOT/і:MORPH/н:MORPH
оның	о:ROOT/ның:MORPH
ұрыста	ұрыс:ROOT/та:MORPH
философтың	философ:ROOT/тың:MORPH
ала	ала:ROOT
қалжыңдасқан	қалжың:ROOT/дас:MORPH/қан:MORPH
Плотин	Плотин:ROOT
Аристофанға	Аристофан:ROOT/ға:MORPH
алатын	ал:ROOT/атын:MORPH
босай	боса:ROOT/й:MORPH
Бірнеше	Бірнеше:ROOT
даналықтың	дана:ROOT/лықт:MORPH/ың:MORPH
қатар	қатар:ROOT
аудармасын	аудар:ROOT/ма:MORPH/сын:MORPH
аталған	ата:ROOT/л:MORPH/ған:MORPH
жеткілікті	жеткі:ROOT/лік:MORPH/ті:MORPH
елдегі	ел:ROOT/де:MORPH/гі:MORPH
Қарапайым	Қарапайым:ROOT
Агафонға	Агафон:ROOT/ға:MORPH
Париждегі	Париж:ROOT/де:MORPH/гі:MORPH
жазылған	жаз:ROOT/ыл:MORPH/ған:MORPH
педагогикалық	педагогика:ROOT/лық:MORPH
болады	бол:ROOT/а:MORPH/ды:MORPH
жетпей	жет:ROOT/пе:MORPH/й:MORPH
ол	ол:ROOT
олармен	о:ROOT/лар:MORPH/мен:MORPH
басында	бас:ROOT/ын:MORPH/да:MORPH
Локк	Локк:ROOT
астар	астар:ROOT
береді	бер:ROOT/е:MORPH/ді:MORPH
елеусіз	еле:ROOT/у:MORPH/сіз:MORPH
мойындаған	мойын:ROOT/да:MORPH/ған:MORPH
көргеніміздей	көр:ROOT/ген:MORPH/іміз:MORPH/дей:MORPH
саясат	саясат:ROOT
үйлесімді	үйлес:ROOT/ім:MORPH/ді:MORPH
өтінеді	өтін:ROOT/е:MORPH/ді:MORPH
философ	философ:ROOT
тілінде	тіл:ROOT/і:MORPH/н:MORPH/де:MORPH
дегеніміз	де:ROOT/ген:MORPH/іміз:MORPH
ерекше	ерек:ROOT/ше:MORPH
хатында	хат:ROOT/ы:MORPH/н:MORPH/да:MORPH
тізбегі	тізбег:ROOT/і:MORPH
деп	деп:ROOT
ал	ал:ROOT
патша	патша:ROOT
диалогтың	диалог:ROOT/тың:MORPH
қалуды	қал:ROOT/у:MORPH/ды:MORPH
тағайындайды	тағай:ROOT/ын:MORPH/да:MORPH/й:MORPH/ды:MORPH
Локк	Локк:ROOT
жылы	жыл:ROOT/ы:MORPH
емдеу	емде:ROOT/у:MORPH
келеді	кел:ROOT/е:MORPH/ді:MORPH
әрқайсысының	әрқайсы:ROOT/сы:MORPH/ның:MORPH
тұрғысында	тұрғы:ROOT/сы:MORPH/н:MORPH/да:MORPH
көрсе	көр:ROOT/се:MORPH
ойдан	ой:ROOT/дан:MORPH
табу	таб:ROOT/у:MORPH
біздің	біз:ROOT/дің:MORPH
бұл	бұл:ROOT
тәртіпті	тәртіп:ROOT/ті:MORPH
түсініктің	түсінік:ROOT/тің:MORPH
Декарттың	Декарт:ROOT/тың:MORPH
рационализациялау	рационализация:ROOT/ла:MORPH/у:MORPH
жақын	жақын:ROOT
ден	ден:ROOT
іс	іс:ROOT
қайнар	қайна:ROOT/р:MORPH
байқағанымыздай	байқа:ROOT/ған:MORPH/ымыз:MORPH/дай:MORPH
бір	бір:ROOT
Сократтың	Сократ:ROOT/тың:MORPH
шығарып	шығар:ROOT/ып:MORPH
байыптауға	байып:ROOT/та:MORPH/у:MORPH/ға:MORPH
нені	не:ROOT/ні:MORPH
ғана	ғана:ROOT
Симпозиумда	Симпозиум:ROOT/да:MORPH
Себебі	Себебі:ROOT
дедуктивті	дедуктив:ROOT/ті:MORPH
артықшылығын	артық:ROOT/шылығ:MORPH/ын:MORPH
келген	кел:ROOT/ген:MORPH
Дегенмен	Де:ROOT/ген:MORPH/мен:MORPH
кәсіп	кәсіп:ROOT
іздеп	ізде:ROOT/п:MORPH
гөрі	гөрі:ROOT
нысанға	нысан:ROOT/ға:MORPH
Агафон	Агафон:ROOT
мен	мен:ROOT
атаған	ата:ROOT/ған:MORPH
баурап	баура:ROOT/п:MORPH
байқалады	байқ:ROOT/ал:MORPH/а:MORPH/ды:MORPH
жүзінде	жүз:ROOT/і:MORPH/н:MORPH/де:MORPH
кем	кем:ROOT
суырылып	суыр:ROOT/ыл:MORPH/ып:MORPH
беруі	бер:ROOT/у:MORPH/і:MORPH
зерттейді	зерт:ROOT/те:MORPH/й:MORPH/ді:MORPH
түсіреді	түсір:ROOT/е:MORPH/ді:MORPH
сатылы	саты:ROOT/лы:MORPH
Аристофанның	Аристофан:ROOT/ның:MORPH
тәржімесінде	тәржі:ROOT/ме:MORPH/сі:MORPH/н:MORPH/де:MORPH
интеллектуалды	интеллектуал:ROOT/ды:MORPH
Аугустиннен	Аугустин:ROOT/нен:MORPH
тұлға	тұлға:ROOT
достығы	достығ:ROOT/ы:MORPH
дұрысы	дұрыс:ROOT/ы:MORPH
ең	ең:ROOT
туралы	туралы:ROOT
ізгі	із:ROOT/гі:MORPH
жасөспірім	жасөспірім:ROOT
Декарт	Декарт:ROOT
нақты	нақты:ROOT
келген	кел:ROOT/ген:MORPH
білімі	білім:ROOT/і:MORPH
тәржімеленді	тәржі:ROOT/ме:MORPH/лен:MORPH/ді:MORPH
байыптау	байып:ROOT/та:MORPH/у:MORPH
әйгілі	әйгі:ROOT/лі:MORPH
Әлемді	Әлем:ROOT/ді:MORPH
органикалық	органика:ROOT/лық:MORPH
Сондықтан	Сондықтан:ROOT
данагөй	дана:ROOT/гөй:MORPH
ету	ет:ROOT/у:MORPH
ағылшын	ағылшын:ROOT
білдіретін	біл:ROOT/дір:MORPH/етін:MORPH
жазды	жаз:ROOT/ды:MORPH
өз	өз:ROOT
тұруға	тұр:ROOT/у:MORPH/ға:MORPH
және	және:ROOT
мәжбүрлеп	мәжбүр:ROOT/ле:MORPH/п:MORPH
айтып	айт:ROOT/ып:MORPH
қалу	қал:ROOT/у:MORPH
Сократтың	Сократ:ROOT/тың:MORPH
қарсыластары	қарсы:ROOT/лас:MORPH/тар:MORPH/ы:MORPH
әдіс	әдіс:ROOT
кітаптарын	кітап:ROOT/тар:MORPH/ы:MORPH/н:MORPH
кезде	кез:ROOT/де:MORPH
деген	де:ROOT/ген:MORPH
философ	философ:ROOT
адал	адал:ROOT
тұлғалардың	тұлға:ROOT/лар:MORPH/дың:MORPH
ойын	ой:ROOT/ы:MORPH/н:MORPH
жалғаса	жалғас:ROOT/а:MORPH
бұл	бұл:ROOT
Мұнда	Мұн:ROOT/да:MORPH
Ол	Ол:ROOT
аңғарылады	аңғар:ROOT/ыл:MORPH/а:MORPH/ды:MORPH
қарай	қара:ROOT/й:MORPH
бір	бір:ROOT
бағыт	бағыт:ROOT
дүниетанымында	дүниетаным:ROOT/ы:MORPH/н:MORPH/да:MORPH
толықтырады	толық:ROOT/тыр:MORPH/а:MORPH/ды:MORPH
қақпасын	қақпа:ROOT/сы:MORPH/н:MORPH
соған	со:ROOT/ған:MORPH
алғаналмағанын	ал:ROOT/ғанал:MORPH/ма:MORPH/ған:MORPH/ын:MORPH
сувереннің	суверен:ROOT/нің:MORPH
қарапайым	қарапайым:ROOT
қаһары	қаһар:ROOT/ы:MORPH
сезімдердің	сез:ROOT/ім:MORPH/дер:MORPH/дің:MORPH
деген	де:ROOT/ген:MORPH
қаламаған	қала:ROOT/ма:MORPH/ған:MORPH
болып	бол:ROOT/ып:MORPH
ұғымын	ұғым:ROOT/ы:MORPH/н:MORPH
таңғажайып	таңғажайып:ROOT
әділдікті	әділ:ROOT/дік:MORPH/ті:MORPH
шығуда	шығ:ROOT/у:MORPH/да:MORPH
пікірдің	пікір:ROOT/дің:MORPH
қолы	қол:ROOT/ы:MORPH
орган	орган:ROOT
бейнесі	бейне:ROOT/сі:MORPH
қарастырады	қарас:ROOT/тыр:MORPH/а:MORPH/ды:MORPH
келтіріп	кел:ROOT/тір:MORPH/іп:MORPH
мәнінде	мән:ROOT/і:MORPH/н:MORPH/де:MORPH
дәріс	дәріс:ROOT
сөз	сөз:ROOT
Бұл	Бұл:ROOT
адам	адам:ROOT
адамдардың	адам:ROOT/дар:MORPH/дың:MORPH
туралы	туралы:ROOT
сол	сол:ROOT
қабылдайды	қабыл:ROOT/да:MORPH/й:MORPH/ды:MORPH
бұл	бұл:ROOT
Декарттың	Декарт:ROOT/тың:MORPH
жүйесі	жүйе:ROOT/сі:MORPH
Алғашқы	Алғашқы:ROOT
Дегенмен	Де:ROOT/ген:MORPH/мен:MORPH
диалог	диалог:ROOT
Қанағат	Қанағат:ROOT
емес	е:ROOT/мес:MORPH
атқа	ат:ROOT/қа:MORPH
философының	философы:ROOT/ның:MORPH
басқаратын	басқар:ROOT/атын:MORPH
туралы	туралы:ROOT
Ол	Ол:ROOT
онда	он:ROOT/да:MORPH
шығармаға	шығ:ROOT/ар:MORPH/ма:MORPH/ға:MORPH
рефлексияға	рефлексия:ROOT/ға:MORPH
пікірінше	пікір:ROOT/і:MORPH/н:MORPH/ше:MORPH
баяндауға	баян:ROOT/да:MORPH/у:MORPH/ға:MORPH
ұсынады	ұсын:ROOT/а:MORPH/ды:MORPH
түсінікті	түсін:ROOT/ік:MORPH/ті:MORPH
Симпозиумнан	Симпозиум:ROOT/нан:MORPH
парасаттылық	парасат:ROOT/ты:MORPH/лық:MORPH
мәжбүр	мәжбүр:ROOT
Ол	Ол:ROOT
деген	де:ROOT/ген:MORPH
ойшыл	ой:ROOT/шыл:MORPH
салдарға	салдар:ROOT/ға:MORPH
ұмтылыс	ұмтылыс:ROOT
тәуелді	тәуел:ROOT/ді:MORPH
ымырамен	ымыра:ROOT/мен:MORPH
және	және:ROOT
ғана	ғана:ROOT
оқырманның	оқ:ROOT/ыр:MORPH/ман:MORPH/ның:MORPH
ол	ол:ROOT
дегеніміз	деген:ROOT/і:MORPH/міз:MORPH
байқампаздық	байқампаз:ROOT/дық:MORPH
пен	пен:ROOT
қатысушы	қатыс:ROOT/у:MORPH/шы:MORPH
сыртқы	сырт:ROOT/қы:MORPH
ол	ол:ROOT
туындаған	туын:ROOT/да:MORPH/ған:MORPH
ерік	ерік:ROOT
болуға	бол:ROOT/у:MORPH/ға:MORPH
арқылы	арқылы:ROOT
өз	өз:ROOT
шешіміне	шешім:ROOT/і:MORPH/не:MORPH
ақыл	ақыл:ROOT
осындай	осын:ROOT/дай:MORPH
Эросқа	Эрос:ROOT/қа:MORPH
де	де:ROOT
Локк	Локк:ROOT
бергенін	бер:ROOT/ген:MORPH/і:MORPH/н:MORPH
оның	о:ROOT/ның:MORPH
саласындағы	сала:ROOT/сы:MORPH/нда:MORPH/ғы:MORPH
қозғайды	қозға:ROOT/й:MORPH/ды:MORPH
дәуірдің	дәуір:ROOT/дің:MORPH
отырған	отыр:ROOT/ған:MORPH
дегеніміз	де:ROOT/ген:MORPH/іміз:MORPH
мен	мен:ROOT
көз	көз:ROOT
және	және:ROOT
ең	ең:ROOT
айтады	айт:ROOT/а:MORPH/ды:MORPH
II	II:ROOT
жарқырап	жарқ:ROOT/ыра:MORPH/п:MORPH
бұл	бұл:ROOT
бірбірін	бірбір:ROOT/і:MORPH/н:MORPH
тұжырымды	тұжырым:ROOT/ды:MORPH
хабар	хабар:ROOT
Құдайдың	Құдай:ROOT/дың:MORPH
сөздері	сөз:ROOT/дер:MORPH/і:MORPH
айтыстарынан	айт:ROOT/ыс:MORPH/тар:MORPH/ы:MORPH/нан:MORPH
Оның	О:ROOT/ның:MORPH
барысынан	барыс:ROOT/ы:MORPH/нан:MORPH
жауабы	жауаб:ROOT/ы:MORPH
Сократты	Сократ:ROOT/ты:MORPH
алады	ал:ROOT/а:MORPH/ды:MORPH
Ең	Ең:ROOT
еш	еш:ROOT
артық	артық:ROOT
көрсетілген	көрсетілген:ROOT
мен	мен:ROOT
формаларының	форма:ROOT/лар:MORPH/ы:MORPH/ның:MORPH
кедергі	кедергі:ROOT
Әрі	Әрі:ROOT
осы	осы:ROOT
Платонның	Платонның:ROOT
Дәлелді	Дәлел:ROOT/ді:MORPH
негізінде	негіз:ROOT/і:MORPH/н:MORPH/де:MORPH
шығармаларында	шығ:ROOT/ар:MORPH/ма:MORPH/лар:MORPH/ын:MORPH/д:MORPH/а:MORPH
сала	сала:ROOT
әртүрлі	әртүр:ROOT/лі:MORPH
түрлі	түр:ROOT/лі:MORPH
әсер	әсер:ROOT
көрсету	көрсет:ROOT/у:MORPH
объектілерін	объекті:ROOT/лер:MORPH/і:MORPH/н:MORPH
осындай	осын:ROOT/дай:MORPH
бірбіріне	бірбір:ROOT/і:MORPH/не:MORPH
бөлігінде	бөліг:ROOT/і:MORPH/нде:MORPH
Ал	Ал:ROOT
әжуалайды	әжуала:ROOT/й:MORPH/ды:MORPH
өйткені	өйткені:ROOT
де	де:ROOT
адал	адал:ROOT
бір	бір:ROOT
пайымдау	пайым:ROOT/да:MORPH/у:MORPH
диалогында	диалог:ROOT/ы:MORPH/нда:MORPH
бермесе	бер:ROOT/ме:MORPH/се:MORPH
содан	со:ROOT/дан:MORPH
түріндегі	түр:ROOT/і:MORPH/н:MORPH/де:MORPH/гі:MORPH
Сезімдерге	Сез:ROOT/ім:MORPH/дер:MORPH/ге:MORPH
оның	о:ROOT/ның:MORPH
жымдаса	жымда:ROOT/са:MORPH
пікірлерін	пікір:ROOT/лер:MORPH/і:MORPH/н:MORPH
жынысы	жыны:ROOT/сы:MORPH
таным	тан:ROOT/ым:MORPH
Мемлекет	Мемлекет:ROOT
Бастапқыда	Бастап:ROOT/қы:MORPH/да:MORPH
тілінде	тіл:ROOT/і:MORPH/н:MORPH/де:MORPH
оқиғаларды	оқиға:ROOT/лар:MORPH/ды:MORPH
саясат	саясат:ROOT
Бұдан	Бұ:ROOT/дан:MORPH
теріс	теріс:ROOT
яғни	яғни:ROOT
Декарт	Декарт:ROOT
да	да:ROOT
иррационалды	иррационал:ROOT/ды:MORPH
дүниенің	дүние:ROOT/нің:MORPH
қалдырды	қал:ROOT/дыр:MORPH/ды:MORPH
табудың	табу:ROOT/дың:MORPH
Мерсенн	Мерсенн:ROOT
философия	философия:ROOT
құмарлық	құмар:ROOT/лық:MORPH
көңілді	көңіл:ROOT/ді:MORPH
арқасында	арқа:ROOT/сы:MORPH/н:MORPH/да:MORPH
күштен	күш:ROOT/тен:MORPH
алдамшы	алдам:ROOT/шы:MORPH
мәнінде	мән:ROOT/і:MORPH/н:MORPH/де:MORPH
мақсаты	мақсат:ROOT/ы:MORPH
бағынатын	бағы:ROOT/н:MORPH/атын:MORPH
өнерінде	өнер:ROOT/і:MORPH/н:MORPH/де:MORPH
соң	соң:ROOT
тиген	ти:ROOT/ген:MORPH
арнаға	арна:ROOT/ға:MORPH
ізбасары	ізбасар:ROOT/ы:MORPH
идеологиялық	идеология:ROOT/лық:MORPH
теріске	теріс:ROOT/ке:MORPH
ұқсастығын	ұқсас:ROOT/тығ:MORPH/ы:MORPH/н:MORPH
Байлық	Бай:ROOT/лық:MORPH
мадақ	мадақ:ROOT
басты	бас:ROOT/ты:MORPH
көтерілу	көтер:ROOT/іл:MORPH/у:MORPH
ол	ол:ROOT
образдар	образ:ROOT/дар:MORPH
Платон	Платон:ROOT
өзінің	өз:ROOT/і:MORPH/нің:MORPH
сөзбен	сөз:ROOT/бен:MORPH
Бірақ	Бірақ:ROOT
данышпанның	данышпан:ROOT/ның:MORPH
махаббаты	махабба:ROOT/ты:MORPH
тұтас	тұтас:ROOT
ештеңе	ештеңе:ROOT
философиялық	философия:ROOT/лық:MORPH
символдық	символ:ROOT/дық:MORPH
болғаны	бол:ROOT/ған:MORPH/ы:MORPH
қыбырлаған	қыбыр:ROOT/ла:MORPH/ған:MORPH
бірдей	бір:ROOT/дей:MORPH
құралы	құрал:ROOT/ы:MORPH
Оның	О:ROOT/ның:MORPH
дәстүріне	дәс:ROOT/түр:MORPH/і:MORPH/не:MORPH
мүмкіндік	мүмкін:ROOT/дік:MORPH
мақсат	мақсат:ROOT
пікірін	пікір:ROOT/ін:MORPH
бастаса	бас:ROOT/та:MORPH/са:MORPH
ұғымын	ұғым:ROOT/ы:MORPH/н:MORPH
мен	мен:ROOT
Платонның	Платон:ROOT/ның:MORPH
бағытталған	бағыт:ROOT/тал:MORPH/ған:MORPH
емес	емес:ROOT
Нағыз	Нағыз:ROOT
кітапқа	кітап:ROOT/қа:MORPH
не	не:ROOT
адамды	адам:ROOT/ды:MORPH
жете	жет:ROOT/е:MORPH
тудырмайтын	ту:ROOT/дыр:MORPH/ма:MORPH/йтын:MORPH
ұғымының	ұғым:ROOT/ы:MORPH/ның:MORPH
Мысалы	Мысалы:ROOT
бермейді	бер:ROOT/ме:MORPH/й:MORPH/ді:MORPH
ықпалға	ық:ROOT/пал:MORPH/ға:MORPH
заңның	заң:ROOT/ның:MORPH
және	және:ROOT
ұстанған	ұстан:ROOT/ған:MORPH
құрастыру	құр:ROOT/ас:MORPH/тыр:MORPH/у:MORPH
Эриксимахпен	Эриксимахп:ROOT/ен:MORPH
Философ	Философ:ROOT
бірінші	бір:ROOT/інші:MORPH
нықтай	нық:ROOT/тай:MORPH
бастамасы	баста:ROOT/ма:MORPH/сы:MORPH
өзіне	өз:ROOT/і:MORPH/не:MORPH
кешке	кеш:ROOT/ке:MORPH
анықтайтын	анық:ROOT/та:MORPH/йтын:MORPH
құдай	құдай:ROOT
төлтума	төлтума:ROOT
сақтаушы	сақта:ROOT/у:MORPH/шы:MORPH
немесе	немесе:ROOT
формада	форма:ROOT/да:MORPH
айтуымызға	айт:ROOT/у:MORPH/ымыз:MORPH/ға:MORPH
қырынан	қыр:ROOT/ы:MORPH/нан:MORPH
сұхбат	сұхбат:ROOT
әдіснамалық	әдіс:ROOT/нама:MORPH/лық:MORPH
жарысына	жарыс:ROOT/ы:MORPH/на:MORPH
теориясы	теория:ROOT/сы:MORPH
Оның	О:ROOT/ның:MORPH
Купердің	Купер:ROOT/дің:MORPH
шыңы	шың:ROOT/ы:MORPH
ең	ең:ROOT
шындығынан	шындығ:ROOT/ы:MORPH/нан:MORPH
дәрігері	дәрі:ROOT/гер:MORPH/і:MORPH
нақтылай	нақты:ROOT/лай:MORPH
ұғынатын	ұғын:ROOT/атын:MORPH
түсті	түс:ROOT/ті:MORPH
жүзінде	жүз:ROOT/і:MORPH/н:MORPH/де:MORPH
бастап	баста:ROOT/п:MORPH
қуаты	қуат:ROOT/ы:MORPH
қалыпты	қалып:ROOT/ты:MORPH
сипат	сипат:ROOT
қауым	қауым:ROOT
бәрінен	бәрі:ROOT/нен:MORPH
Ақын	Ақын:ROOT
көп	көп:ROOT
болады	бол:ROOT/а:MORPH/ды:MORPH
болып	бол:ROOT/ып:MORPH
досы	досы:ROOT
та	та:ROOT
атымен	ат:ROOT/ы:MORPH/мен:MORPH
болудың	бол:ROOT/у:MORPH/дың:MORPH
есептейді	есеп:ROOT/те:MORPH/й:MORPH/ді:MORPH
нәтижесінде	нәтиже:ROOT/сі:MORPH/н:MORPH/де:MORPH
жалғыздығына	жалғыз:ROOT/дығ:MORPH/ы:MORPH/на:MORPH
әлеміне	әлем:ROOT/і:MORPH/не:MORPH
келісімшарттар	келісім:ROOT/шарт:MORPH/тар:MORPH
аузына	ауз:ROOT/ы:MORPH/на:MORPH
Бұған	Бұ:ROOT/ған:MORPH
білігін	біл:ROOT/іг:MORPH/ін:MORPH
одан	о:ROOT/дан:MORPH
VI	VI:ROOT
да	да:ROOT
қабылданғанға	қабыл:ROOT/дан:MORPH/ған:MORPH/ға:MORPH
ұстаным	ұстаным:ROOT
шәкірт	шәкірт:ROOT
салу	сал:ROOT/у:MORPH
ұғынуға	ұғын:ROOT/у:MORPH/ға:MORPH
тек	тек:ROOT
Билік	Би:ROOT/лік:MORPH
диалогтармен	диалог:ROOT/тар:MORPH/мен:MORPH
орынды	орын:ROOT/ды:MORPH
алмайды	ал:ROOT/ма:MORPH/й:MORPH/ды:MORPH
қасиеттер	қасиет:ROOT/тер:MORPH
өнер	өнер:ROOT
Осы	Осы:ROOT
тұжырымдамасының	тұжырымдама:ROOT/сы:MORPH/ның:MORPH
келіп	кел:ROOT/іп:MORPH
Платон	Платон:ROOT
ынтызар	ынтызар:ROOT
деген	де:ROOT/ген:MORPH
тәжірибелер	тәжірибе:ROOT/лер:MORPH
дулы	ду:ROOT/лы:MORPH
аттанады	аттан:ROOT/а:MORPH/ды:MORPH
олардың	о:ROOT/лар:MORPH/дың:MORPH
арқасында	арқа:ROOT/сы:MORPH/н:MORPH/да:MORPH
мысқылмен	мысқыл:ROOT/мен:MORPH
шарттар	шарт:ROOT/тар:MORPH
қарымқатынасқа	қарымқатынас:ROOT/қа:MORPH
байыптауға	байып:ROOT/та:MORPH/у:MORPH/ға:MORPH
адамның	адам:ROOT/ның:MORPH
ойлаймын	ой:ROOT/ла:MORPH/й:MORPH/мын:MORPH
Платонның	Платон:ROOT/ның:MORPH
дұрыс	дұрыс:ROOT
жағынан	жағ:ROOT/ы:MORPH/нан:MORPH
рефлексия	рефлексия:ROOT
философ	философ:ROOT
түстер	түс:ROOT/тер:MORPH
адамдарды	адам:ROOT/дар:MORPH/ды:MORPH
туралы	туралы:ROOT
жүйесіне	жүйе:ROOT/сі:MORPH/не:MORPH
салатынын	сал:ROOT/атын:MORPH/ы:MORPH/н:MORPH
болады	бол:ROOT/а:MORPH/ды:MORPH
жарқын	жарқ:ROOT/ын:MORPH
бойынша	бойын:ROOT/ша:MORPH
қайшылық	қайшы:ROOT/лық:MORPH
әкетуге	әкет:ROOT/у:MORPH/ге:MORPH
Павсаний	Павсаний:ROOT
мәселелерін	мәселе:ROOT/лер:MORPH/ін:MORPH
келген	кел:ROOT/ген:MORPH
Алкивиад	Алкивиад:ROOT
рационалды	рационал:ROOT/ды:MORPH
тілмен	тіл:ROOT/мен:MORPH
көру	көр:ROOT/у:MORPH
оның	о:ROOT/ның:MORPH
ілімінің	ілім:ROOT/і:MORPH/нің:MORPH
реттелген	рет:ROOT/тел:MORPH/ген:MORPH
фигура	фигура:ROOT
түсіндіруден	түсін:ROOT/дір:MORPH/у:MORPH/ден:MORPH
көмектеседі	көмек:ROOT/тес:MORPH/е:MORPH/ді:MORPH
бойынша	бой:ROOT/ы:MORPH/н:MORPH/ша:MORPH
логикалық	логика:ROOT/лық:MORPH
барлық	барлық:ROOT
бермек	бер:ROOT/мек:MORPH
тұшымды	тұшым:ROOT/ды:MORPH
термин	термин:ROOT
өзара	өзара:ROOT
мен	мен:ROOT
тек	тек:ROOT
надан	надан:ROOT
астындағы	аст:ROOT/ы:MORPH/н:MORPH/да:MORPH/ғы:MORPH
Егер	Егер:ROOT
тигеннен	тиген:ROOT/нен:MORPH
Сократ	Сократ:ROOT
сын	сын:ROOT
Алуан	Алуан:ROOT
тартып	тарт:ROOT/ып:MORPH
шығарған	шығар:ROOT/ған:MORPH
біледі	біл:ROOT/е:MORPH/ді:MORPH
мәселелері	мәселе:ROOT/лер:MORPH/і:MORPH
эстетика	эстетика:ROOT
дейтін	де:ROOT/йтін:MORPH
Диалогтың	Диалог:ROOT/тың:MORPH
оймен	ой:ROOT/мен:MORPH
комедиясының	комедия:ROOT/сы:MORPH/ның:MORPH
ұстанымның	ұстаным:ROOT/ның:MORPH
келісім	келіс:ROOT/ім:MORPH
fantasme	fantasme:ROOT
таным	тан:ROOT/ым:MORPH
үшін	үшін:ROOT
бірі	бір:ROOT/і:MORPH
Дегенмен	Дегенмен:ROOT
Бұл	Бұл:ROOT
іліммен	ілім:ROOT/мен:MORPH
мүмкіндік	мүмкін:ROOT/дік:MORPH
араласып	ара:ROOT/ла:MORPH/с:MORPH/ып:MORPH
күмән	күмән:ROOT
қызыл	қызыл:ROOT
шешімді	шеш:ROOT/ім:MORPH/ді:MORPH
табиғаты	табиғат:ROOT/ы:MORPH
мемлекеттік	мемлекет:ROOT/тік:MORPH
дейін	дейін:ROOT
көркем	көркем:ROOT
Агафонға	Агафон:ROOT/ға:MORPH
бар	бар:ROOT
деген	де:ROOT/ген:MORPH
ЖЛ	ЖЛ:ROOT
дәлелдеуге	дәлел:ROOT/де:MORPH/у:MORPH/ге:MORPH
ақиқатқа	ақиқат:ROOT/қа:MORPH
Аристофанның	Аристофан:ROOT/ның:MORPH
Бұл	Бұл:ROOT
сүйене	сүйен:ROOT/е:MORPH
шығарманың	шығ:ROOT/ар:MORPH/ма:MORPH/ның:MORPH
дегеніміз	деген:ROOT/іміз:MORPH
махаббаттың	махаббат:ROOT/тың:MORPH
ағылшын	ағылшын:ROOT
өлім	өл:ROOT/ім:MORPH
заңдары	заң:ROOT/дар:MORPH/ы:MORPH
бұл	бұл:ROOT
деген	де:ROOT/ген:MORPH
төніп	төн:ROOT/іп:MORPH
тәсілі	тәсіл:ROOT/і:MORPH
және	және:ROOT
бірден	бір:ROOT/ден:MORPH
өту	өт:ROOT/у:MORPH
және	және:ROOT
деп	деп:ROOT
түсіндіруге	түс:ROOT/ін:MORPH/дір:MORPH/у:MORPH/ге:MORPH
құдіреті	құдірет:ROOT/і:MORPH
та	та:ROOT
философтардың	философ:ROOT/тар:MORPH/дың:MORPH
жылы	жыл:ROOT/ы:MORPH
ғасыр	ғасыр:ROOT
керемет	керемет:ROOT
үшін	үшін:ROOT
пайымның	пайым:ROOT/ның:MORPH
Декарттың	Декарт:ROOT/тың:MORPH
өз	өз:ROOT
анықтап	анық:ROOT/та:MORPH/п:MORPH
қол	қол:ROOT
айтылады	айт:ROOT/ыл:MORPH/а:MORPH/ды:MORPH
тб	тб:ROOT
Ұстазы	Ұстаз:ROOT/ы:MORPH
екіұдай	екі:ROOT/ұдай:MORPH
Ойлаймын	Ой:ROOT/ла:MORPH/й:MORPH/мын:MORPH
сөзі	сөз:ROOT/і:MORPH
теңесе	тең:ROOT/ес:MORPH/е:MORPH
тәнге	тән:ROOT/ге:MORPH
жәрдем	жәрдем:ROOT
Әлемді	Әлем:ROOT/ді:MORPH
мен	мен:ROOT
Аугустин	Аугустин:ROOT
қаузап	қауза:ROOT/п:MORPH
соғатындай	соғ:ROOT/атын:MORPH/дай:MORPH
өре	өр:ROOT/е:MORPH
канцлер	канцлер:ROOT
әрекетінен	әрекет:ROOT/і:MORPH/нен:MORPH
қазасы	қазас:ROOT/ы:MORPH
шешен	шешен:ROOT
қарекет	қарекет:ROOT
ықпал	ықпал:ROOT
тұтпай	тұт:ROOT/па:MORPH/й:MORPH
осы	осы:ROOT
ұмтылысы	ұмты:ROOT/лыс:MORPH/ы:MORPH
кетеді	кетеді:ROOT
да	да:ROOT
Симпозиумға	Симпозиум:ROOT/ға:MORPH
идеяға	идея:ROOT/ға:MORPH
екіге	екі:ROOT/ге:MORPH
әпсана	әпсана:ROOT
осы	осы:ROOT
идеясы	идея:ROOT/сы:MORPH
шеңберінен	шеңбер:ROOT/і:MORPH/нен:MORPH
кемеліне	кемел:ROOT/і:MORPH/не:MORPH
дүрбімен	дүрбі:ROOT/мен:MORPH
ойшылды	ой:ROOT/шыл:MORPH/ды:MORPH
тартылысты	тарт:ROOT/ылыс:MORPH/ты:MORPH
Локк	Локк:ROOT
ешқандай	ешқандай:ROOT
білмейді	біл:ROOT/ме:MORPH/й:MORPH/ді:MORPH
Осы	Осы:ROOT
артық	артық:ROOT
Симпозиумда	Симпозиум:ROOT/да:MORPH
Автор	Автор:ROOT
жарып	жар:ROOT/ып:MORPH
неге	неге:ROOT
жолы	жол:ROOT/ы:MORPH
Сіз	Сіз:ROOT
ортақ	ортақ:ROOT
ерекшелік	ерекше:ROOT/лік:MORPH
ілімі	ілім:ROOT/і:MORPH
теориясының	теория:ROOT/сы:MORPH/ның:MORPH
Алайда	Алайда:ROOT
Кедейліктің	Кедей:ROOT/лік:MORPH/тің:MORPH
сондай	сон:ROOT/дай:MORPH
Платон	Платон:ROOT
болғанымыз	бол:ROOT/ған:MORPH/ы:MORPH/мыз:MORPH
мінсіздігін	мін:ROOT/сіз:MORPH/діг:MORPH/і:MORPH/н:MORPH
әлемде	әлем:ROOT/де:MORPH
рух	рух:ROOT
бастауы	баста:ROOT/у:MORPH/ы:MORPH
тек	тек:ROOT
айтып	айт:ROOT/ып:MORPH
һәм	һәм:ROOT
бағытталған	бағыт:ROOT/тал:MORPH/ған:MORPH
мойындамай	мойын:ROOT/да:MORPH/ма:MORPH/й:MORPH
болады	бол:ROOT/а:MORPH/ды:MORPH
жоқ	жоқ:ROOT
мемлекетті	мемлекет:ROOT/ті:MORPH
Осы	Осы:ROOT
оны	о:ROOT/ны:MORPH
түседі	түс:ROOT/е:MORPH/ді:MORPH
Аугустин	Аугустин:ROOT
тіпті	тіпті:ROOT
сияқты	сияқты:ROOT
мысалы	мысал:ROOT/ы:MORPH
билікке	билік:ROOT/ке:MORPH
азанқазан	азанқазан:ROOT
немесе	немесе:ROOT
бірақ	бірақ:ROOT
шынымен	шын:ROOT/ы:MORPH/мен:MORPH
тойдуманға	тойдуман:ROOT/ға:MORPH
кейінгі	кейін:ROOT/гі:MORPH
қате	қате:ROOT
қосып	қос:ROOT/ып:MORPH
пікірлерден	пікір:ROOT/лер:MORPH/ден:MORPH
қадам	қадам:ROOT
табатын	таб:ROOT/атын:MORPH
артық	артық:ROOT
ой	ой:ROOT
басқару	басқар:ROOT/у:MORPH
сипаты	сипат:ROOT/ы:MORPH
қайшылықты	қайшы:ROOT/лық:MORPH/ты:MORPH
жылы	жыл:ROOT/ы:MORPH
өмір	өмір:ROOT
ол	ол:ROOT
қызметінен	қызмет:ROOT/і:MORPH/нен:MORPH
көзқарастарын	көз:ROOT/қарас:MORPH/тар:MORPH/ын:MORPH
Әңгімеге	Әңгіме:ROOT/ге:MORPH
Осы	Осы:ROOT
пікірталас	пікір:ROOT/талас:MORPH
эстетика	эстетика:ROOT
беру	бер:ROOT/у:MORPH
Алкивиад	Алкивиад:ROOT
ал	ал:ROOT
астатөк	астатөк:ROOT
оның	о:ROOT/ның:MORPH
кітап	кітап:ROOT
кез	кез:ROOT
метафоралық	метафора:ROOT/лық:MORPH
шаһары	шаһар:ROOT/ы:MORPH
түсіндіргеннен	түсін:ROOT/дір:MORPH/ген:MORPH/нен:MORPH
біз	біз:ROOT
Бастапқыда	Баста:ROOT/п:MORPH/қы:MORPH/да:MORPH
келісе	келіс:ROOT/е:MORPH
Француз	Француз:ROOT
алғаны	ал:ROOT/ған:MORPH/ы:MORPH
тарихы	тарих:ROOT/ы:MORPH
барынша	барын:ROOT/ша:MORPH
материал	материал:ROOT
сөйлегісі	сөйле:ROOT/гі:MORPH/сі:MORPH
жаратылыс	жарат:ROOT/ылыс:MORPH
шешімді	шешім:ROOT/ді:MORPH
аңғал	аңғал:ROOT
әкейге	әкей:ROOT/ге:MORPH
бастарына	бас:ROOT/тар:MORPH/ы:MORPH/на:MORPH
Томас	Томас:ROOT
ұлы	ұлы:ROOT
Әйтсе	Әйт:ROOT/се:MORPH
атқаны	ат:ROOT/қан:MORPH/ы:MORPH
үшін	үшін:ROOT
күннің	күн:ROOT/нің:MORPH
бейбітшілікке	бейбіт:ROOT/ші:MORPH/лік:MORPH/ке:MORPH
Лейбниц	Лейбниц:ROOT
Махаббат	Махаббат:ROOT
де	де:ROOT
жанрларында	жанр:ROOT/лар:MORPH/ы:MORPH/н:MORPH/да:MORPH
мәнері	мәнер:ROOT/і:MORPH
мен	мен:ROOT
Декарт	Декарт:ROOT
Осы	Осы:ROOT
білдірудегі	біл:ROOT/дір:MORPH/у:MORPH/де:MORPH/гі:MORPH
Әпсанада	Әпсана:ROOT/да:MORPH
бақытқа	бақыт:ROOT/қа:MORPH
қызметтері	қызмет:ROOT/тер:MORPH/і:MORPH
пайдалануға	пайда:ROOT/лан:MORPH/у:MORPH/ға:MORPH
ішкі	іш:ROOT/кі:MORPH
қайғылы	қайғы:ROOT/лы:MORPH
философ	философ:ROOT
өзі	өз:ROOT/і:MORPH
шықпаған	шық:ROOT/па:MORPH/ған:MORPH
оларды	о:ROOT/лар:MORPH/ды:MORPH
сай	сай:ROOT
иландыруға	илан:ROOT/дыр:MORPH/у:MORPH/ға:MORPH
бірбіріне	бірбір:ROOT/і:MORPH/не:MORPH
философиядан	философия:ROOT/дан:MORPH
ғана	ғана:ROOT
адам	адам:ROOT
дәріс	дәріс:ROOT
болып	бол:ROOT/ып:MORPH
бұл	бұл:ROOT
түйсікке	түйсік:ROOT/ке:MORPH
дейін	дейін:ROOT
Сократ	Сократ:ROOT
дастарқандас	дастарқан:ROOT/дас:MORPH
біліміміздің	біл:ROOT/ім:MORPH/і:MORPH/міз:MORPH/дің:MORPH
ғана	ғана:ROOT
жайында	жай:ROOT/ы:MORPH/н:MORPH/да:MORPH
өзі	өз:ROOT/і:MORPH
деңгейінде	деңгей:ROOT/і:MORPH/н:MORPH/де:MORPH
Аристофанның	Аристофан:ROOT/ның:MORPH
және	және:ROOT
сөз	сөз:ROOT
соң	соң:ROOT
бұл	бұл:ROOT
ғана	ғана:ROOT
құралы	құрал:ROOT/ы:MORPH
эмпирикалық	эмпирика:ROOT/лық:MORPH
гүлдестесімен	гүл:ROOT/дес:MORPH/тес:MORPH/і:MORPH/мен:MORPH
топшылайды	топшыла:ROOT/й:MORPH/ды:MORPH
оралып	орал:ROOT/ып:MORPH
өзара	өз:ROOT/ара:MORPH
үстірттеу	үстірт:ROOT/теу:MORPH
тән	тән:ROOT
қарсы	қарсы:ROOT
философ	философ:ROOT
лебізі	лебіз:ROOT/і:MORPH
өмір	өмір:ROOT
қоятын	қо:ROOT/ятын:MORPH
физик	физик:ROOT
оқырмандарын	оқ:ROOT/ыр:MORPH/ман:MORPH/дар:MORPH/ын:MORPH
екеуі	еке:ROOT/у:MORPH/і:MORPH
асқан	ас:ROOT/қан:MORPH
тырнақалды	тырнақ:ROOT/ал:MORPH/ды:MORPH
атпен	ат:ROOT/пен:MORPH
бұл	бұл:ROOT
азықтүлікпен	азықтүлік:ROOT/пен:MORPH
алды	ал:ROOT/ды:MORPH
бірбеткей	бір:ROOT/бет:MORPH/кей:MORPH
дәуірде	дәуір:ROOT/де:MORPH
жылғы	жыл:ROOT/ғы:MORPH
Локк	Локк:ROOT
шынайы	шынай:ROOT/ы:MORPH
Олардың	Олар:ROOT/дың:MORPH
затын	зат:ROOT/ы:MORPH/н:MORPH
еңбектің	еңбек:ROOT/тің:MORPH
баяндайды	баян:ROOT/да:MORPH/й:MORPH/ды:MORPH
Оның	О:ROOT/ның:MORPH
салмақ	салмақ:ROOT
іш	іш:ROOT
қайта	қайт:ROOT/а:MORPH
іздеудің	ізде:ROOT/у:MORPH/дің:MORPH
ережелерін	ереже:ROOT/лер:MORPH/і:MORPH/н:MORPH
жылы	жылы:ROOT
жанның	жан:ROOT/ның:MORPH
француз	француз:ROOT
ретінде	рет:ROOT/і:MORPH/н:MORPH/де:MORPH
тұтады	тұт:ROOT/а:MORPH/ды:MORPH
диалогтарында	диалог:ROOT/тар:MORPH/ы:MORPH/нда:MORPH
кейін	кейін:ROOT
ол	ол:ROOT
Корольге	Король:ROOT/ге:MORPH
Көңілді	Көңіл:ROOT/ді:MORPH
ажалсыз	ажал:ROOT/сыз:MORPH
Басқа	Басқа:ROOT
Платонның	Платон:ROOT/ның:MORPH
шығармалар	шығ:ROOT/ар:MORPH/ма:MORPH/лар:MORPH
басым	басым:ROOT
мүмкіндік	мүмкін:ROOT/дік:MORPH
түсіндіретін	түсін:ROOT/дір:MORPH/етін:MORPH
оның	о:ROOT/ның:MORPH
сұйық	сұйық:ROOT
ұмтылған	ұмт:ROOT/ыл:MORPH/ған:MORPH
сүйіспеншілікпен	сүй:ROOT/іс:MORPH/пен:MORPH/шілік:MORPH/пен:MORPH
аз	аз:ROOT
тану	тан:ROOT/у:MORPH
оның	о:ROOT/ның:MORPH
арасында	ара:ROOT/сы:MORPH/н:MORPH/да:MORPH
Келесі	Келесі:ROOT
меңгерген	мең:ROOT/гер:MORPH/ген:MORPH
адамдарға	адам:ROOT/дар:MORPH/ға:MORPH
философ	философ:ROOT
туралы	туралы:ROOT
софист	софист:ROOT
қарамақайшылықтың	қарамақайшы:ROOT/лық:MORPH/тың:MORPH
ғана	ғана:ROOT
сәйкес	сәйкес:ROOT
Локк	Локк:ROOT
деп	деп:ROOT
дейін	дейін:ROOT
береді	бер:ROOT/е:MORPH/ді:MORPH
Фрэнсис	Фрэнсис:ROOT
Зевстің	Зевс:ROOT/тің:MORPH
санайды	сана:ROOT/й:MORPH/ды:MORPH
алтыншы	алт:ROOT/ыншы:MORPH
мен	мен:ROOT
тыңдаушыларды	тың:ROOT/да:MORPH/у:MORPH/шы:MORPH/лар:MORPH/ды:MORPH
босатады	боса:ROOT/т:MORPH/а:MORPH/ды:MORPH
де	де:ROOT
игерген	игер:ROOT/ген:MORPH
махаббат	махаббат:ROOT
де	де:ROOT
оқытылатын	оқыт:ROOT/ыл:MORPH/атын:MORPH
Алайда	Алайда:ROOT
билік	би:ROOT/лік:MORPH
дерті	дерт:ROOT/і:MORPH
біз	біз:ROOT
мен	мен:ROOT
Диотима	Диотима:ROOT
Олай	Олай:ROOT
екі	екі:ROOT
бар	бар:ROOT
әрқилы	әрқил:ROOT/ы:MORPH
айтады	айт:ROOT/а:MORPH/ды:MORPH
айтуынша	айт:ROOT/у:MORPH/ы:MORPH/н:MORPH/ша:MORPH
туралы	туралы:ROOT
философиялық	философия:ROOT/лық:MORPH
гөрі	гөрі:ROOT
ғана	ғана:ROOT
болған	бол:ROOT/ған:MORPH
ең	ең:ROOT
құралы	құрал:ROOT/ы:MORPH
Ол	Ол:ROOT
өмірін	өмір:ROOT/і:MORPH/н:MORPH
ғашық	ғашық:ROOT
Сұхбаттасушыларға	Сұхбат:ROOT/тас:MORPH/у:MORPH/шы:MORPH/лар:MORPH/ға:MORPH
саяси	саяс:ROOT/и:MORPH
махаббаты	махаббат:ROOT/ы:MORPH
Құдайларды	Құдай:ROOT/лар:MORPH/ды:MORPH
тәжірибелер	тәжірибе:ROOT/лер:MORPH
тақырыптарды	тақырып:ROOT/тар:MORPH/ды:MORPH
сұхбатқа	сұхбат:ROOT/қа:MORPH
өміріне	өмір:ROOT/і:MORPH/не:MORPH
теориясын	теория:ROOT/сы:MORPH/н:MORPH
өзге	өз:ROOT/ге:MORPH
түсіп	түс:ROOT/іп:MORPH
Дегенмен	Деген:ROOT/мен:MORPH
байыпты	байып:ROOT/ты:MORPH
жол	жол:ROOT
Платонның	Платон:ROOT/ның:MORPH
пікірталасты	пікір:ROOT/талас:MORPH/ты:MORPH
бедерленген	бедер:ROOT/лен:MORPH/ген:MORPH
кіршіксіз	кір:ROOT/шік:MORPH/сіз:MORPH
себепкер	себеп:ROOT/кер:MORPH
түйінін	түйін:ROOT/ін:MORPH
сөйлейді	сөйле:ROOT/й:MORPH/ді:MORPH
геометрия	геометрия:ROOT
терминді	термин:ROOT/ді:MORPH
туралы	туралы:ROOT
Диоген	Диоген:ROOT
Кенеттен	Кенет:ROOT/тен:MORPH
ноталардың	нота:ROOT/лар:MORPH/дың:MORPH
және	және:ROOT
ету	ет:ROOT/у:MORPH
махаббаттың	махаббат:ROOT/тың:MORPH
шығармасының	шығ:ROOT/ар:MORPH/ма:MORPH/сы:MORPH/ның:MORPH
мәнін	мән:ROOT/і:MORPH/н:MORPH
өңделіп	өң:ROOT/де:MORPH/л:MORPH/іп:MORPH
Осы	Осы:ROOT
Сонымен	Со:ROOT/ны:MORPH/мен:MORPH
логикасымен	логика:ROOT/сы:MORPH/мен:MORPH
заттану	заттану:ROOT
иелерін	ие:ROOT/лер:MORPH/ін:MORPH
суверенге	суверен:ROOT/ге:MORPH
Бұл	Бұл:ROOT
жүйелі	жүйе:ROOT/лі:MORPH
Агафонмен	Агафон:ROOT/мен:MORPH
түйінді	түй:ROOT/ін:MORPH/ді:MORPH
шешен	шешен:ROOT
мәнермен	мәнер:ROOT/мен:MORPH
көне	көне:ROOT
көрсетеді	көр:ROOT/се:MORPH/т:MORPH/е:MORPH/ді:MORPH
кейінгі	кейін:ROOT/гі:MORPH
тиіс	тиіс:ROOT
тарауымен	тарау:ROOT/ы:MORPH/мен:MORPH
тұрақсыздық	тұр:ROOT/ақ:MORPH/сыз:MORPH/дық:MORPH
яғни	яғни:ROOT
мұра	мұра:ROOT
бұл	бұл:ROOT
Осы	Осы:ROOT
тиек	тиек:ROOT
оларға	о:ROOT/лар:MORPH/ға:MORPH
еді	е:ROOT/ді:MORPH
философ	философ:ROOT
деп	деп:ROOT
Алкивиад	Алкивиад:ROOT
азаматтық	азамат:ROOT/тық:MORPH
ақиқат	ақиқат:ROOT
Никола	Никола:ROOT
жылы	жыл:ROOT/ы:MORPH
Мерсенн	Мерсенн:ROOT
қысымымен	қысым:ROOT/ы:MORPH/мен:MORPH
платондық	платон:ROOT/дық:MORPH
мен	мен:ROOT
Алғашқы	Алғаш:ROOT/қы:MORPH
жарық	жарық:ROOT
кез	кез:ROOT
көрінеді	көрін:ROOT/е:MORPH/ді:MORPH
осы	осы:ROOT
бір	бір:ROOT
өмір	өмір:ROOT
Эшлиді	Эшли:ROOT/ді:MORPH
үшін	үшін:ROOT
жасаған	жаса:ROOT/ған:MORPH
тұрғыдан	тұр:ROOT/ғы:MORPH/дан:MORPH
ізгіліктерге	ізгілік:ROOT/тер:MORPH/ге:MORPH
өмірі	өмір:ROOT/і:MORPH
бармайды	бар:ROOT/ма:MORPH/й:MORPH/ды:MORPH
заңға	заң:ROOT/ға:MORPH
қалмайды	қал:ROOT/ма:MORPH/й:MORPH/ды:MORPH
өзіне	өз:ROOT/і:MORPH/не:MORPH
еріксіз	ерік:ROOT/сіз:MORPH
Керісінше	Керісін:ROOT/ше:MORPH
шыққан	шық:ROOT/қан:MORPH
философияға	философия:ROOT/ға:MORPH
одан	о:ROOT/дан:MORPH
басым	басым:ROOT
емес	е:ROOT/ме:MORPH/с:MORPH
мәселе	мәселе:ROOT
тарата	тарат:ROOT/а:MORPH
Платон	Платон:ROOT
да	да:ROOT
жасай	жаса:ROOT/й:MORPH
жетуге	жет:ROOT/у:MORPH/ге:MORPH
анықтау	анық:ROOT/та:MORPH/у:MORPH
махаббаттың	махаббат:ROOT/тың:MORPH
игіліктердің	игі:ROOT/лік:MORPH/тер:MORPH/дің:MORPH
тұтастығын	тұтас:ROOT/тығ:MORPH/ы:MORPH/н:MORPH
құдайлардың	құдай:ROOT/лар:MORPH/дың:MORPH
жасалған	жаса:ROOT/л:MORPH/ған:MORPH
әсерлі	әсер:ROOT/лі:MORPH
екенін	е:ROOT/кен:MORPH/і:MORPH/н:MORPH
алдымен	алды:ROOT/мен:MORPH
баяндауы	баян:ROOT/да:MORPH/у:MORPH/ы:MORPH
әлдекімді	әлде:ROOT/кім:MORPH/ді:MORPH
қозғалыстың	қозғалыс:ROOT/тың:MORPH
танытады	таны:ROOT/т:MORPH/а:MORPH/ды:MORPH
қозғайды	қозға:ROOT/й:MORPH/ды:MORPH
ды	ды:ROOT
ұлы	ұлы:ROOT
туралы	туралы:ROOT
кімдерге	кім:ROOT/дер:MORPH/ге:MORPH
туралы	туралы:ROOT
үйрену	үйрен:ROOT/у:MORPH
елігу	еліг:ROOT/у:MORPH
иелері	ие:ROOT/лер:MORPH/і:MORPH
философ	философ:ROOT
және	және:ROOT
мұрасындағы	мұра:ROOT/сын:MORPH/да:MORPH/ғы:MORPH
атуға	ат:ROOT/у:MORPH/ға:MORPH
трагедиясының	трагедия:ROOT/сы:MORPH/ның:MORPH
оның	о:ROOT/ның:MORPH
тағы	тағы:ROOT
жақындау	жақын:ROOT/да:MORPH/у:MORPH
жүйеде	жүйе:ROOT/де:MORPH
айналысады	айналыс:ROOT/а:MORPH/ды:MORPH
Анығында	Анығ:ROOT/ы:MORPH/н:MORPH/да:MORPH
арасындағы	ара:ROOT/сы:MORPH/н:MORPH/да:MORPH/ғы:MORPH
көрінеді	көр:ROOT/ін:MORPH/е:MORPH/ді:MORPH
Ол	Ол:ROOT
та	та:ROOT
жасайды	жаса:ROOT/й:MORPH/ды:MORPH
бастайды	баста:ROOT/й:MORPH/ды:MORPH
шындығында	шын:ROOT/дығ:MORPH/ы:MORPH/н:MORPH/да:MORPH
Мен	Мен:ROOT
айтпаған	айт:ROOT/па:MORPH/ған:MORPH
жалықтыратын	жалық:ROOT/тыр:MORPH/атын:MORPH
мадақ	мадақ:ROOT
жетуге	жет:ROOT/у:MORPH/ге:MORPH
омонимиясы	омонимия:ROOT/сы:MORPH
мән	мән:ROOT
сенуге	сен:ROOT/у:MORPH/ге:MORPH
ахуал	ахуал:ROOT
алдымен	алд:ROOT/ы:MORPH/мен:MORPH
ол	ол:ROOT
баяндалған	баян:ROOT/да:MORPH/л:MORPH/ған:MORPH
Симпозиумнан	Симпозиум:ROOT/нан:MORPH
Ол	Ол:ROOT
қарсы	қарсы:ROOT
жеткізгенді	жет:ROOT/кіз:MORPH/ген:MORPH/ді:MORPH
да	да:ROOT
Диалектика	Диалектика:ROOT
тұтанды	тұтан:ROOT/ды:MORPH
бірқатар	бірқатар:ROOT
күйреуіне	күйре:ROOT/у:MORPH/і:MORPH/не:MORPH
күрделі	күрде:ROOT/лі:MORPH
соңында	соң:ROOT/ы:MORPH/нда:MORPH
адамның	адам:ROOT/ның:MORPH
жасамыс	жасамыс:ROOT
Мальбранш	Мальбранш:ROOT
келіп	кел:ROOT/іп:MORPH
жүйелейді	жүйе:ROOT/ле:MORPH/й:MORPH/ді:MORPH
билік	би:ROOT/лік:MORPH
танысты	таныс:ROOT/ты:MORPH
салатын	сал:ROOT/атын:MORPH
сұрақтың	сұрақ:ROOT/тың:MORPH
ЖЛ	ЖЛ:ROOT
философия	философия:ROOT
оның	о:ROOT/ның:MORPH
Философиямен	Философия:ROOT/мен:MORPH
анасының	ана:ROOT/сы:MORPH/ның:MORPH
жоғары	жоғары:ROOT
пойэсис	пойэсис:ROOT
аз	аз:ROOT
Диалектика	Диалектика:ROOT
барып	бар:ROOT/ып:MORPH
қожайынның	қожайын:ROOT/ның:MORPH
бөлшектердің	бөлшек:ROOT/тер:MORPH/дің:MORPH
еңбек	еңбек:ROOT
мен	мен:ROOT
айтатын	айт:ROOT/атын:MORPH
құбылмалы	құбыл:ROOT/малы:MORPH
санада	сана:ROOT/да:MORPH
Алкие	Алкие:ROOT
болды	бол:ROOT/ды:MORPH
көзқарасын	көз:ROOT/қарас:MORPH/ын:MORPH
Ол	Ол:ROOT
кейін	кейін:ROOT
дәлелдерді	дәлел:ROOT/дер:MORPH/ді:MORPH
деп	де:ROOT/п:MORPH
де	де:ROOT
үшін	үшін:ROOT
авторы	автор:ROOT/ы:MORPH
және	және:ROOT
бір	бір:ROOT
қатаң	қатаң:ROOT
өздеріне	өз:ROOT/дер:MORPH/і:MORPH/не:MORPH
Диоптрикада	Диоптрика:ROOT/да:MORPH
философтардан	философ:ROOT/тар:MORPH/дан:MORPH
да	да:ROOT
барысында	барыс:ROOT/ы:MORPH/н:MORPH/да:MORPH
орыннан	орын:ROOT/нан:MORPH
айырылып	айыр:ROOT/ыл:MORPH/ып:MORPH
тәптіштеп	тәптіш:ROOT/те:MORPH/п:MORPH
осы	осы:ROOT
бастапқы	бастап:ROOT/қы:MORPH
қиыншылыққа	қиын:ROOT/шылық:MORPH/қа:MORPH
табиғи	табиғи:ROOT
туралы	туралы:ROOT
Декарт	Декарт:ROOT
қолдан	қол:ROOT/дан:MORPH
бейнесіне	бейне:ROOT/сі:MORPH/не:MORPH
олар	о:ROOT/лар:MORPH
трактатының	трактат:ROOT/ы:MORPH/ның:MORPH
секілді	секілді:ROOT
қазіргі	қазір:ROOT/гі:MORPH
сипаты	сипат:ROOT/ы:MORPH
лорд	лорд:ROOT
Одан	О:ROOT/дан:MORPH
шартты	шарт:ROOT/ты:MORPH
бірбіріне	бірбір:ROOT/і:MORPH/не:MORPH
бас	бас:ROOT
қабілетінің	қабілет:ROOT/і:MORPH/нің:MORPH
мен	мен:ROOT
кезде	кез:ROOT/де:MORPH
қатысты	қатыс:ROOT/ты:MORPH
логикалық	логика:ROOT/лық:MORPH
ушы	у:ROOT/шы:MORPH
елдердің	ел:ROOT/дер:MORPH/дің:MORPH
бұл	бұл:ROOT
жергілікті	жергі:ROOT/лік:MORPH/ті:MORPH
іс	іс:ROOT
шартты	шарт:ROOT/ты:MORPH
ағылшын	ағылшын:ROOT
бәрі	бәрі:ROOT
бола	бол:ROOT/а:MORPH
Сол	Сол:ROOT
дейінгі	дейін:ROOT/гі:MORPH
сауалды	сауал:ROOT/ды:MORPH
метафизика	метафизика:ROOT
пікірлер	пікір:ROOT/лер:MORPH
Эростың	Эрос:ROOT/тың:MORPH
келтірудің	кел:ROOT/тір:MORPH/у:MORPH/дің:MORPH
білдіреді	біл:ROOT/дір:MORPH/е:MORPH/ді:MORPH
тәжірибесінен	тәжірибе:ROOT/сі:MORPH/нен:MORPH
әңгіме	әңгіме:ROOT
өз	өз:ROOT
тазалығы	таза:ROOT/лығ:MORPH/ы:MORPH
Симпозиумның	Симпозиум:ROOT/ның:MORPH
диалогқа	диалог:ROOT/қа:MORPH
мәселелерді	мәселе:ROOT/лер:MORPH/ді:MORPH
тағдыры	тағдыр:ROOT/ы:MORPH
Аугустиннің	Аугустин:ROOT/нің:MORPH
көпшілікке	көп:ROOT/ші:MORPH/лік:MORPH/ке:MORPH
бір	бір:ROOT
әртүрлі	әр:ROOT/түр:MORPH/лі:MORPH
мен	мен:ROOT
ерлерді	ер:ROOT/лер:MORPH/ді:MORPH
қоса	қос:ROOT/а:MORPH
жаңа	жаңа:ROOT
көкірегінде	көкірег:ROOT/і:MORPH/н:MORPH/де:MORPH
бір	бір:ROOT
Аристотельдің	Аристотель:ROOT/дің:MORPH
бұйрығымен	бұйрығ:ROOT/ы:MORPH/мен:MORPH
ақылпарасатының	ақылпарасат:ROOT/ы:MORPH/ның:MORPH
туралы	туралы:ROOT
адам	адам:ROOT
әбес	әбес:ROOT
болатынын	бол:ROOT/атын:MORPH/ын:MORPH
шектеледі	шек:ROOT/те:MORPH/л:MORPH/е:MORPH/ді:MORPH
басқа	басқа:ROOT
міндетті	міндет:ROOT/ті:MORPH
бағамдалады	бағам:ROOT/дал:MORPH/а:MORPH/ды:MORPH
сызықпен	сызық:ROOT/пен:MORPH
анық	анық:ROOT
Агафонның	Агафон:ROOT/ның:MORPH
дүниені	дүние:ROOT/ні:MORPH
түсіндіреді	түсін:ROOT/дір:MORPH/е:MORPH/ді:MORPH
ақиқатты	ақиқат:ROOT/ты:MORPH
көрсетеді	көр:ROOT/се:MORPH/т:MORPH/е:MORPH/ді:MORPH
жалғасы	жалғас:ROOT/ы:MORPH
философтың	философ:ROOT/тың:MORPH
тоғысқан	тоғыс:ROOT/қан:MORPH
билікке	би:ROOT/лік:MORPH/ке:MORPH
оған	о:ROOT/ған:MORPH
сенімсіздік	сен:ROOT/ім:MORPH/сіз:MORPH/дік:MORPH
есептеді	есеп:ROOT/т:MORPH/е:MORPH/ді:MORPH
шешендердің	шешен:ROOT/дер:MORPH/дің:MORPH
көру	көр:ROOT/у:MORPH
сүйенетін	сүйен:ROOT/етін:MORPH
түсіріп	түс:ROOT/ір:MORPH/іп:MORPH
айналдырумен	айнал:ROOT/дыр:MORPH/у:MORPH/мен:MORPH
толы	толы:ROOT
ниетпен	ниет:ROOT/пен:MORPH
отырып	отыр:ROOT/ып:MORPH
бәрінен	бәр:ROOT/і:MORPH/нен:MORPH
мақсатында	мақсат:ROOT/ы:MORPH/нда:MORPH
Бұл	Бұл:ROOT
Өйткені	Өйткені:ROOT
адамдардың	адам:ROOT/дар:MORPH/дың:MORPH
теріске	теріс:ROOT/ке:MORPH
бәрін	бәрін:ROOT
де	де:ROOT
арқылы	арқылы:ROOT
өнімі	өнім:ROOT/і:MORPH
беретін	бер:ROOT/етін:MORPH
объектілер	объекті:ROOT/лер:MORPH
мүлде	мүлде:ROOT
ашуға	ашу:ROOT/ға:MORPH
олар	о:ROOT/лар:MORPH
бөлікке	бөлік:ROOT/ке:MORPH
келген	кел:ROOT/ген:MORPH
жиналғандардан	жина:ROOT/л:MORPH/ған:MORPH/дар:MORPH/дан:MORPH
қалыптасуы	қалып:ROOT/тас:MORPH/у:MORPH/ы:MORPH
факультетінде	факультет:ROOT/і:MORPH/н:MORPH/де:MORPH
мәнінде	мән:ROOT/і:MORPH/н:MORPH/де:MORPH
әзелгі	әзел:ROOT/гі:MORPH
кейінгі	кейін:ROOT/гі:MORPH
көлденең	көлденең:ROOT
тізгінін	тізгін:ROOT/і:MORPH/н:MORPH
еткенін	ет:ROOT/кен:MORPH/і:MORPH/н:MORPH
Бұл	Бұл:ROOT
туралы	туралы:ROOT
ойларын	ой:ROOT/лар:MORPH/ы:MORPH/н:MORPH
бөлек	бөлек:ROOT
екенін	е:ROOT/кен:MORPH/ін:MORPH
ғылымдар	ғылым:ROOT/дар:MORPH
әлі	әлі:ROOT
екі	екі:ROOT
Алкивиадтың	Алкивиад:ROOT/тың:MORPH
сөйлеу	сөйле:ROOT/у:MORPH
шығармасы	шығ:ROOT/ар:MORPH/ма:MORPH/сы:MORPH
бірер	бірер:ROOT
мағынасы	мағына:ROOT/сы:MORPH
жылдардың	жыл:ROOT/дар:MORPH/дың:MORPH
бастап	бас:ROOT/та:MORPH/п:MORPH
идеялардың	идея:ROOT/лар:MORPH/дың:MORPH
деп	де:ROOT/п:MORPH
XI	XI:ROOT
кең	кең:ROOT
ақыры	ақыры:ROOT
ілімі	ілім:ROOT/і:MORPH
жыл	жыл:ROOT
ойлар	ой:ROOT/лар:MORPH
бұл	бұл:ROOT
Олардан	О:ROOT/лар:MORPH/дан:MORPH
жүйе	жүйе:ROOT
Шатле	Шатле:ROOT
өзіне	өз:ROOT/і:MORPH/не:MORPH
ескертпелерін	ескер:ROOT/т:MORPH/пе:MORPH/лер:MORPH/і:MORPH/н:MORPH
алуандығын	алуан:ROOT/дығ:MORPH/ы:MORPH/н:MORPH
ықпалын	ықпа:ROOT/лы:MORPH/н:MORPH
болар	бол:ROOT/ар:MORPH
алып	ал:ROOT/ып:MORPH
ескертуіміз	ескер:ROOT/т:MORPH/у:MORPH/іміз:MORPH
Өйткені	Өйткені:ROOT
барлығының	барлығ:ROOT/ы:MORPH/ның:MORPH
манифест	манифест:ROOT
өздеріне	өз:ROOT/дер:MORPH/і:MORPH/не:MORPH
білімді	біл:ROOT/ім:MORPH/ді:MORPH
дәлел	дәлел:ROOT
бермеуінің	бер:ROOT/ме:MORPH/у:MORPH/і:MORPH/нің:MORPH
тоғысады	тоғыс:ROOT/а:MORPH/ды:MORPH
тәні	тән:ROOT/і:MORPH
оның	о:ROOT/ның:MORPH
барын	бар:ROOT/ы:MORPH/н:MORPH
туралы	туралы:ROOT
өз	өз:ROOT
ұйғарады	ұйғар:ROOT/а:MORPH/ды:MORPH
тұжырымдағандай	тұжырым:ROOT/да:MORPH/ған:MORPH/дай:MORPH
төртінші	төрт:ROOT/інші:MORPH
түсу	түс:ROOT/у:MORPH
махаббат	махаббат:ROOT
құқы	құқ:ROOT/ы:MORPH
ерекшеленеді	ерекше:ROOT/лен:MORPH/е:MORPH/ді:MORPH
патша	патша:ROOT
ажалсыздық	ажал:ROOT/сыз:MORPH/дық:MORPH
түсіндіретін	түс:ROOT/ін:MORPH/дір:MORPH/етін:MORPH
туындысы	туынды:ROOT/сы:MORPH
адамның	адам:ROOT/ның:MORPH
ынтызарлық	ынтызар:ROOT/лық:MORPH
артықшылығы	артық:ROOT/шылығ:MORPH/ы:MORPH
Франсуа	Франсуа:ROOT
композициясы	композиция:ROOT/сы:MORPH
алғашқы	алғаш:ROOT/қы:MORPH
Платон	Платон:ROOT
Ол	Ол:ROOT
махаббаты	махаббат:ROOT/ы:MORPH
жобаны	жоба:ROOT/ны:MORPH
тек	тек:ROOT
қазіргі	қазір:ROOT/гі:MORPH
айырылған	айыр:ROOT/ыл:MORPH/ған:MORPH
соған	со:ROOT/ған:MORPH
ақиқат	ақиқат:ROOT
жетелейтін	жете:ROOT/ле:MORPH/йтін:MORPH
Бұқара	Бұқара:ROOT
сұхбаттың	сұхбат:ROOT/тың:MORPH
дәйектемелер	дәйек:ROOT/теме:MORPH/лер:MORPH
жеке	жеке:ROOT
Сол	Сол:ROOT
жұрт	жұрт:ROOT
береді	бер:ROOT/е:MORPH/ді:MORPH
сауығу	сауығ:ROOT/у:MORPH
айтылады	айт:ROOT/ыл:MORPH/а:MORPH/ды:MORPH
келтіру	келтір:ROOT/у:MORPH
Сократ	Сократ:ROOT
ұмтылды	ұмтыл:ROOT/ды:MORPH
әкелу	әкел:ROOT/у:MORPH
Симпозиумның	Симпозиум:ROOT/ның:MORPH
түсіндіріп	түсін:ROOT/дір:MORPH/іп:MORPH
әңгіменің	әңгіме:ROOT/нің:MORPH
салыстыра	салыс:ROOT/тыр:MORPH/а:MORPH
Гоббс	Гоббс:ROOT
жол	жол:ROOT
және	және:ROOT
ал	ал:ROOT
кәсіпқой	кәсіп:ROOT/қой:MORPH
Спинозаның	Спиноза:ROOT/ның:MORPH
осы	осы:ROOT
әйел	әйел:ROOT
Левиафан	Левиафан:ROOT
Бірақ	Бірақ:ROOT
лайықталмаған	лайық:ROOT/та:MORPH/л:MORPH/ма:MORPH/ған:MORPH
аяқталады	аяқ:ROOT/та:MORPH/ла:MORPH/ды:MORPH
көрінеді	көр:ROOT/ін:MORPH/е:MORPH/ді:MORPH
қысылуына	қыс:ROOT/ыл:MORPH/у:MORPH/ы:MORPH/на:MORPH
әкесінің	әке:ROOT/сі:MORPH/нің:MORPH
Өйткені	Өйткені:ROOT
ұласады	ұлас:ROOT/а:MORPH/ды:MORPH
лар	лар:ROOT
түрткі	түрт:ROOT/кі:MORPH
пайдаланады	пайда:ROOT/лан:MORPH/а:MORPH/ды:MORPH
Геометрия	Геометрия:ROOT
әр	әр:ROOT
табыну	табын:ROOT/у:MORPH
Табиғи	Табиғ:ROOT/и:MORPH
білім	білім:ROOT
Сократтың	Сократ:ROOT/тың:MORPH
үйлестіре	үйлес:ROOT/тір:MORPH/е:MORPH
туралы	туралы:ROOT
шыққан	шық:ROOT/қан:MORPH
тұрғысынан	тұрғы:ROOT/сы:MORPH/нан:MORPH
ойлы	ой:ROOT/лы:MORPH
саясатпен	саясат:ROOT/пен:MORPH
ойсезімдік	ойсе:ROOT/зім:MORPH/дік:MORPH
Сілтеме	Сілте:ROOT/ме:MORPH
Король	Король:ROOT
құтылып	құтыл:ROOT/ып:MORPH
онымен	о:ROOT/ны:MORPH/мен:MORPH
құндылығы	құн:ROOT/дылығ:MORPH/ы:MORPH
Бірақ	Бірақ:ROOT
мағынасында	мағына:ROOT/сы:MORPH/н:MORPH/да:MORPH
тәжірибе	тәжірибе:ROOT
туған	ту:ROOT/ған:MORPH
шаруа	шаруа:ROOT
достарына	дос:ROOT/тар:MORPH/ы:MORPH/на:MORPH
ғылым	ғылым:ROOT
екенін	е:ROOT/кен:MORPH/ін:MORPH
ұнататындардың	ұна:ROOT/т:MORPH/атын:MORPH/дар:MORPH/дың:MORPH
ғылымы	ғылым:ROOT/ы:MORPH
қызықты	қызық:ROOT/ты:MORPH
алады	ал:ROOT/а:MORPH/ды:MORPH
ештеңе	ештеңе:ROOT
тиеді	тиеді:ROOT
нәтижесі	нәтиже:ROOT/сі:MORPH
әкеліп	әкел:ROOT/іп:MORPH
өзегінде	өзег:ROOT/і:MORPH/н:MORPH/де:MORPH
сан	сан:ROOT
табуды	таб:ROOT/у:MORPH/ды:MORPH
саяси	саяс:ROOT/и:MORPH
болады	бол:ROOT/а:MORPH/ды:MORPH
қалып	қал:ROOT/ып:MORPH
ахуалда	ахуал:ROOT/да:MORPH
лордтың	лорд:ROOT/тың:MORPH
ақылды	ақыл:ROOT/ды:MORPH
арналған	арна:ROOT/л:MORPH/ған:MORPH
пайымдар	пайым:ROOT/дар:MORPH
қайғыға	қайғы:ROOT/ға:MORPH
ол	ол:ROOT
жоғалтуы	жоғалт:ROOT/у:MORPH/ы:MORPH
әжуалағанымен	әжуала:ROOT/ған:MORPH/ы:MORPH/мен:MORPH
Пифагордың	Пифагор:ROOT/дың:MORPH
тұлға	тұлға:ROOT
идеялар	идея:ROOT/лар:MORPH
жүргізетін	жүр:ROOT/гіз:MORPH/етін:MORPH
астрономия	астрономия:ROOT
сыр	сыр:ROOT
Аристофанды	Аристофан:ROOT/ды:MORPH
Гоббстің	Гоббс:ROOT/тің:MORPH
зейінділік	зейін:ROOT/ді:MORPH/лік:MORPH
кейін	кейін:ROOT
тізіп	тіз:ROOT/іп:MORPH
ойларды	ой:ROOT/лар:MORPH/ды:MORPH
жаңашылдыққа	жаңа:ROOT/шыл:MORPH/дық:MORPH/қа:MORPH
тартылыс	тарт:ROOT/ыл:MORPH/ыс:MORPH
бірге	бір:ROOT/ге:MORPH
сабақтап	сабақ:ROOT/та:MORPH/п:MORPH
пікірлердің	пікір:ROOT/лер:MORPH/дің:MORPH
жүгінудің	жүгін:ROOT/у:MORPH/дің:MORPH
априори	априори:ROOT
тұруда	тұр:ROOT/у:MORPH/да:MORPH
Бірақ	Бірақ:ROOT
ойын	ой:ROOT/ы:MORPH/н:MORPH
қалдырады	қал:ROOT/дыр:MORPH/а:MORPH/ды:MORPH
алғашқы	алғаш:ROOT/қы:MORPH
махаббат	махаббат:ROOT
және	және:ROOT
танытады	таны:ROOT/т:MORPH/а:MORPH/ды:MORPH
өзінің	өз:ROOT/і:MORPH/нің:MORPH
әділдікті	әділ:ROOT/дік:MORPH/ті:MORPH
сайын	сайын:ROOT
екенін	е:ROOT/кен:MORPH/і:MORPH/н:MORPH
бірінбірі	бір:ROOT/інбір:MORPH/і:MORPH
қарсыластарын	қарсы:ROOT/лас:MORPH/тар:MORPH/ы:MORPH/н:MORPH
өмір	өмір:ROOT
тапса	тап:ROOT/са:MORPH
аздап	аздап:ROOT
қашықтықтан	қашық:ROOT/тық:MORPH/тан:MORPH
Түптеп	Түпте:ROOT/п:MORPH
ПорРояльдің	ПорРояль:ROOT/дің:MORPH
білім	біл:ROOT/ім:MORPH
жүзіне	жүз:ROOT/і:MORPH/не:MORPH
соғысын	соғыс:ROOT/ы:MORPH/н:MORPH
мысалы	мысалы:ROOT
құлқы	құлқ:ROOT/ы:MORPH
орнығуы	орнығ:ROOT/у:MORPH/ы:MORPH
деген	де:ROOT/ген:MORPH
университеттің	университет:ROOT/тің:MORPH
қараудың	қара:ROOT/у:MORPH/дың:MORPH
теорияларға	теория:ROOT/лар:MORPH/ға:MORPH
қабылдау	қабыл:ROOT/да:MORPH/у:MORPH
да	да:ROOT
да	да:ROOT
оның	о:ROOT/ның:MORPH
қойды	қой:ROOT/ды:MORPH
осы	осы:ROOT
көтерілді	көтер:ROOT/іл:MORPH/ді:MORPH
еркін	еркін:ROOT
Толғаныстар	Толған:ROOT/ыс:MORPH/тар:MORPH
баяндаудың	баян:ROOT/да:MORPH/у:MORPH/дың:MORPH
бұл	бұл:ROOT
жылнамалық	жылна:ROOT/ма:MORPH/лық:MORPH
сияқты	сияқты:ROOT
жазған	жаз:ROOT/ған:MORPH
сөздері	сөз:ROOT/дер:MORPH/і:MORPH
оның	о:ROOT/ның:MORPH
арқылы	арқылы:ROOT
пікірлерін	пікір:ROOT/лер:MORPH/і:MORPH/н:MORPH
көбірек	көб:ROOT/ірек:MORPH
пәледен	пәле:ROOT/ден:MORPH
сәулесінің	сәуле:ROOT/сі:MORPH/нің:MORPH
әр	әр:ROOT
бетінде	бет:ROOT/і:MORPH/н:MORPH/де:MORPH
немесе	немесе:ROOT
ойды	ой:ROOT/ды:MORPH
басылып	бас:ROOT/ыл:MORPH/ып:MORPH
рет	рет:ROOT
араласады	аралас:ROOT/а:MORPH/ды:MORPH
тұтас	тұтас:ROOT
соның	со:ROOT/ның:MORPH
асыл	асыл:ROOT
болып	бол:ROOT/ып:MORPH
қылмыс	қылмыс:ROOT
Пікірталасқа	Пікір:ROOT/талас:MORPH/қа:MORPH
Декарт	Декарт:ROOT
тұрған	тұр:ROOT/ған:MORPH
әрекет	әрекет:ROOT
ойын	ой:ROOT/ы:MORPH/н:MORPH
махаббаттың	махаббат:ROOT/тың:MORPH
келісетінінен	келіс:ROOT/етін:MORPH/і:MORPH/нен:MORPH
ғылымның	ғылым:ROOT/ның:MORPH
білуде	біл:ROOT/у:MORPH/де:MORPH
қозғалысты	қозғал:ROOT/ыс:MORPH/ты:MORPH
үшін	үшін:ROOT
Пегги	Пегги:ROOT
кейін	кейін:ROOT
формаға	форма:ROOT/ға:MORPH
екен	е:ROOT/кен:MORPH
сөзі	сөз:ROOT/і:MORPH
өзіне	өз:ROOT/і:MORPH/не:MORPH
болуы	бол:ROOT/у:MORPH/ы:MORPH
кейін	кейін:ROOT
жалғастыра	жалғас:ROOT/тыр:MORPH/а:MORPH
жағдайларды	жағдай:ROOT/лар:MORPH/ды:MORPH
Бұл	Бұл:ROOT
Сұлулық	Сұлу:ROOT/лық:MORPH
дербес	дербес:ROOT
айтуынша	айт:ROOT/у:MORPH/ы:MORPH/н:MORPH/ша:MORPH
идеялардың	идея:ROOT/лар:MORPH/дың:MORPH
жанды	жан:ROOT/ды:MORPH
не	не:ROOT
қозғалыс	қозғалыс:ROOT
ұзақ	ұзақ:ROOT
үңгірдің	үңгір:ROOT/дің:MORPH
Логос	Логос:ROOT
келеді	кел:ROOT/е:MORPH/ді:MORPH
сол	сол:ROOT
төтенше	төтен:ROOT/ше:MORPH
бақытынан	бақыт:ROOT/ы:MORPH/нан:MORPH
негізгі	негіз:ROOT/гі:MORPH
ал	ал:ROOT
және	және:ROOT
болғанын	бол:ROOT/ған:MORPH/ы:MORPH/н:MORPH
тәндік	тән:ROOT/дік:MORPH
орайда	орай:ROOT/да:MORPH
өзінің	өз:ROOT/і:MORPH/нің:MORPH
мүмкіндік	мүмкін:ROOT/дік:MORPH
сабасына	саба:ROOT/сы:MORPH/на:MORPH
дәуірдің	дәуір:ROOT/дің:MORPH
ләззатына	ләззат:ROOT/ы:MORPH/на:MORPH
ақындық	ақын:ROOT/дық:MORPH
қатысты	қатыс:ROOT/ты:MORPH
Эриксимах	Эриксимах:ROOT
Диалогтың	Диалог:ROOT/тың:MORPH
шешендік	шешен:ROOT/дік:MORPH
мазмұннан	мазмұн:ROOT/нан:MORPH
берік	берік:ROOT
жетік	жетік:ROOT
Сократ	Сократ:ROOT
ақиқатты	ақиқат:ROOT/ты:MORPH
алдымен	ал:ROOT/ды:MORPH/мен:MORPH
айтқан	айт:ROOT/қан:MORPH
едәуір	едәуір:ROOT
қалай	қалай:ROOT
ағылшын	ағылшын:ROOT
Дәстүрге	Дәстүр:ROOT/ге:MORPH
әңгімеде	әңгіме:ROOT/де:MORPH
қастерлі	қастер:ROOT/лі:MORPH
іс	іс:ROOT
ажырамаған	ажыра:ROOT/ма:MORPH/ған:MORPH
жоғары	жоғары:ROOT
арасында	ара:ROOT/сы:MORPH/н:MORPH/да:MORPH
ғана	ғана:ROOT
пайымпарасат	пайымпарасат:ROOT
Аристофан	Аристофан:ROOT
Диотиманың	Диотима:ROOT/ның:MORPH
өнерге	өнер:ROOT/ге:MORPH
Махаббат	Махаббат:ROOT
Алкивиад	Алкивиад:ROOT
осы	осы:ROOT
демек	демек:ROOT
кесілгенін	кесіл:ROOT/ген:MORPH/ін:MORPH
өтіп	өт:ROOT/іп:MORPH
түсіріп	түс:ROOT/ір:MORPH/іп:MORPH
сөз	сөз:ROOT
әкелетін	әкел:ROOT/етін:MORPH
ол	ол:ROOT
іліміне	ілім:ROOT/і:MORPH/не:MORPH
пікірі	пікір:ROOT/і:MORPH
және	және:ROOT
Декарт	Декарт:ROOT
келуіне	кел:ROOT/у:MORPH/і:MORPH/не:MORPH
біздің	біз:ROOT/дің:MORPH
Дегенмен	Де:ROOT/ген:MORPH/мен:MORPH
әдістің	әдіс:ROOT/тің:MORPH
аралық	ара:ROOT/лық:MORPH
асқысы	асқ:ROOT/ыс:MORPH/ы:MORPH
себеп	себеп:ROOT
III	III:ROOT
латын	латын:ROOT
шебер	шебер:ROOT
әулекі	әулекі:ROOT
қатысты	қатысты:ROOT
сәйкес	сәйкес:ROOT
Лейбниц	Лейбниц:ROOT
айналысады	айнал:ROOT/ыс:MORPH/а:MORPH/ды:MORPH
сөзін	сөз:ROOT/і:MORPH/н:MORPH
арналған	арна:ROOT/л:MORPH/ған:MORPH
ұрпақ	ұрпақ:ROOT
Логика	Логика:ROOT
шындыққа	шын:ROOT/дық:MORPH/қа:MORPH
сүйенсе	сүйен:ROOT/се:MORPH
дәрігер	дәрі:ROOT/гер:MORPH
ойшылдың	ой:ROOT/шыл:MORPH/дың:MORPH
күш	күш:ROOT
Сократтың	Сократ:ROOT/тың:MORPH
махаббат	махаббат:ROOT
кез	кез:ROOT
болып	бол:ROOT/ып:MORPH
біледі	біл:ROOT/е:MORPH/ді:MORPH
місе	місе:ROOT
осы	осы:ROOT
құштар	құштар:ROOT
кедергі	кедергі:ROOT
тек	тек:ROOT
қателікке	қате:ROOT/лік:MORPH/ке:MORPH
көңіл	көңіл:ROOT
яки	яки:ROOT
лорд	лорд:ROOT
қозғалысы	қозғалыс:ROOT/ы:MORPH
алғашқы	алғаш:ROOT/қы:MORPH
тіршілік	тір:ROOT/шілік:MORPH
беретін	бер:ROOT/етін:MORPH
құмарлықтан	құмар:ROOT/лық:MORPH/тан:MORPH
дүниелерден	дүние:ROOT/лер:MORPH/ден:MORPH
асып	асып:ROOT
ғана	ғана:ROOT
қызметін	қызмет:ROOT/і:MORPH/н:MORPH
тапқан	тап:ROOT/қан:MORPH
Шешендер	Шешен:ROOT/дер:MORPH
сөз	сөз:ROOT
басталады	баст:ROOT/ал:MORPH/а:MORPH/ды:MORPH
құрастырып	құрас:ROOT/тыр:MORPH/ып:MORPH
шығарма	шығ:ROOT/ар:MORPH/ма:MORPH
ақиқаттан	ақиқат:ROOT/тан:MORPH
алмасымыз	ал:ROOT/мас:MORPH/ымыз:MORPH
Сократтың	Сократ:ROOT/тың:MORPH
иелігін	ие:ROOT/ліг:MORPH/і:MORPH/н:MORPH
түсіріп	түс:ROOT/ір:MORPH/іп:MORPH
сенімнен	сен:ROOT/ім:MORPH/нен:MORPH
дегеніміз	де:ROOT/ген:MORPH/іміз:MORPH
ие	ие:ROOT
күн	күн:ROOT
дәуірдің	дәуір:ROOT/дің:MORPH
бзд	бзд:ROOT
осы	осы:ROOT
көздің	көз:ROOT/дің:MORPH
майевтика	майевтика:ROOT
Ол	Ол:ROOT
алысу	алыс:ROOT/у:MORPH
тыюда	ты:ROOT/ю:MORPH/да:MORPH
тирандарды	тиран:ROOT/дар:MORPH/ды:MORPH
ұмтылысы	ұмты:ROOT/лыс:MORPH/ы:MORPH
Олардың	О:ROOT/лар:MORPH/дың:MORPH
құбылыстары	құбылыс:ROOT/тар:MORPH/ы:MORPH
менің	ме:ROOT/нің:MORPH
тез	тез:ROOT
өз	өз:ROOT
Сократтың	Сократ:ROOT/тың:MORPH
екенін	е:ROOT/кен:MORPH/ін:MORPH
өзіңізге	өз:ROOT/іңіз:MORPH/ге:MORPH
пайдейя	пайдейя:ROOT
лорд	лорд:ROOT
дейін	дейін:ROOT
көрді	көр:ROOT/ді:MORPH
қылады	қыл:ROOT/а:MORPH/ды:MORPH
бағынбайтын	бағын:ROOT/ба:MORPH/йтын:MORPH
Алкивиад	Алкивиад:ROOT
формасында	формас:ROOT/ы:MORPH/н:MORPH/да:MORPH
Тұтас	Тұтас:ROOT
пен	пен:ROOT
дидактикалық	дидактика:ROOT/лық:MORPH
да	да:ROOT
интеллектуалды	интеллектуал:ROOT/ды:MORPH
жай	жай:ROOT
салады	сал:ROOT/а:MORPH/ды:MORPH
философ	философ:ROOT
бұл	бұл:ROOT
Әлеммен	Әлем:ROOT/мен:MORPH
мен	мен:ROOT
бермейді	бер:ROOT/ме:MORPH/й:MORPH/ді:MORPH
диалогтың	диалог:ROOT/тың:MORPH
мен	мен:ROOT
интеллектуалдық	интеллектуал:ROOT/дық:MORPH
ақиқат	ақиқат:ROOT
тиіс	тиіс:ROOT
дей	де:ROOT/й:MORPH
құтылу	құтыл:ROOT/у:MORPH
платондық	платон:ROOT/дық:MORPH
ұясы	ұя:ROOT/сы:MORPH
үшін	үшін:ROOT
мен	мен:ROOT
жеңістің	жеңіс:ROOT/тің:MORPH
теориясын	теория:ROOT/сы:MORPH/н:MORPH
Дәл	Дәл:ROOT
шын	шын:ROOT
ақиқатқа	ақиқат:ROOT/қа:MORPH
Сократ	Сократ:ROOT
терең	терең:ROOT
келісім	келіс:ROOT/ім:MORPH
шектелген	шек:ROOT/тел:MORPH/ген:MORPH
алдыңнан	алд:ROOT/ы:MORPH/ң:MORPH/нан:MORPH
шын	шын:ROOT
мәнінде	мән:ROOT/і:MORPH/н:MORPH/де:MORPH
тарту	тарт:ROOT/у:MORPH
бейілдігін	бейіл:ROOT/діг:MORPH/ін:MORPH
философия	философия:ROOT
кейпінде	кейп:ROOT/і:MORPH/нде:MORPH
кейін	кейін:ROOT
қамтамасыз	қамтама:ROOT/сыз:MORPH
жүйелі	жүйе:ROOT/лі:MORPH
орнын	ор:ROOT/н:MORPH/ын:MORPH
оза	оза:ROOT
мен	мен:ROOT
пайымдаудың	пайым:ROOT/да:MORPH/у:MORPH/дың:MORPH
өзінің	өз:ROOT/і:MORPH/нің:MORPH
ғана	ғана:ROOT
жоғары	жоғары:ROOT
барлық	барлық:ROOT
жарасым	жара:ROOT/сым:MORPH
төнген	төн:ROOT/ген:MORPH
Платон	Платон:ROOT
арнасынан	арна:ROOT/сы:MORPH/нан:MORPH
айтқанда	айт:ROOT/қан:MORPH/да:MORPH
екіге	екі:ROOT/ге:MORPH
олардың	олар:ROOT/дың:MORPH
елжұртының	елжұрт:ROOT/ы:MORPH/ның:MORPH
көпті	көп:ROOT/ті:MORPH
туралы	туралы:ROOT
қуатты	қуат:ROOT/ты:MORPH
оған	о:ROOT/ған:MORPH
айтқанда	айт:ROOT/қан:MORPH/да:MORPH
туралы	туралы:ROOT
тәжірибе	тәжірибе:ROOT
деп	де:ROOT/п:MORPH
болса	бол:ROOT/са:MORPH
шақыру	шақыр:ROOT/у:MORPH
қолдана	қол:ROOT/дан:MORPH/а:MORPH
талқылағанда	талқыла:ROOT/ған:MORPH/да:MORPH
өңделген	өңде:ROOT/л:MORPH/ген:MORPH
сезімнің	сез:ROOT/ім:MORPH/нің:MORPH
теңдеу	тең:ROOT/деу:MORPH
әңгімені	әңгіме:ROOT/ні:MORPH
Сократ	Сократ:ROOT
түсіндірілуге	түсін:ROOT/дір:MORPH/іл:MORPH/у:MORPH/ге:MORPH
Әдетте	Әдет:ROOT/те:MORPH
әлеуметтану	әлеуметтану:ROOT
мен	мен:ROOT
қоғамдық	қоғам:ROOT/дық:MORPH
Әрине	Әрине:ROOT
мақсаты	мақсат:ROOT/ы:MORPH
заң	заң:ROOT
енді	енді:ROOT
оның	о:ROOT/ның:MORPH
айқын	айқын:ROOT
Сократ	Сократ:ROOT
суверен	суверен:ROOT
өмірге	өмір:ROOT/ге:MORPH
мәселесін	мәселе:ROOT/сі:MORPH/н:MORPH
Федр	Федр:ROOT
бөліктерін	бөліктер:ROOT/і:MORPH/н:MORPH
ерекше	ерек:ROOT/ше:MORPH
жоғары	жоғары:ROOT
болмайды	бол:ROOT/ма:MORPH/й:MORPH/ды:MORPH
сезіледі	сез:ROOT/іл:MORPH/е:MORPH/ді:MORPH
стильде	стиль:ROOT/де:MORPH
Құдайға	Құдай:ROOT/ға:MORPH
шығады	шығ:ROOT/а:MORPH/ды:MORPH
оның	о:ROOT/ның:MORPH
жағдайда	жағдай:ROOT/да:MORPH
тұтас	тұтас:ROOT
Содан	Со:ROOT/дан:MORPH
ғана	ғана:ROOT
экономика	экономика:ROOT
төмен	төмен:ROOT
тіпті	тіпті:ROOT
бөлуге	бөл:ROOT/у:MORPH/ге:MORPH
заңын	заң:ROOT/ы:MORPH/н:MORPH
кесіппішіп	кес:ROOT/іппіш:MORPH/іп:MORPH
айрықша	айрық:ROOT/ша:MORPH
құқық	құқық:ROOT
бірдей	бір:ROOT/дей:MORPH
кейінірек	кейінірек:ROOT
сұхбат	сұхбат:ROOT
да	да:ROOT
Симпозиумнан	Симпозиум:ROOT/нан:MORPH
емес	е:ROOT/мес:MORPH
автор	автор:ROOT
игере	игер:ROOT/е:MORPH
жігерленген	жігер:ROOT/лен:MORPH/ген:MORPH
жеткізу	жет:ROOT/кіз:MORPH/у:MORPH
Табиғат	Табиғат:ROOT
Мұнда	Мұн:ROOT/да:MORPH
Симпозиум	Симпозиум:ROOT
Ал	Ал:ROOT
философиялық	философия:ROOT/лық:MORPH
береді	бер:ROOT/е:MORPH/ді:MORPH
тіліндегі	тіл:ROOT/ін:MORPH/де:MORPH/гі:MORPH
оның	о:ROOT/ның:MORPH
тұрғысынан	тұрғыс:ROOT/ы:MORPH/нан:MORPH
оның	о:ROOT/ның:MORPH
құштарлыққа	құштар:ROOT/лық:MORPH/қа:MORPH
Әділдік	Әділ:ROOT/дік:MORPH
бірдебір	бір:ROOT/дебір:MORPH
мән	мән:ROOT
Уоллистің	Уоллис:ROOT/тің:MORPH
ең	ең:ROOT
сәулелері	сәуле:ROOT/лер:MORPH/і:MORPH
өзінше	өзін:ROOT/ше:MORPH
байсалды	байсал:ROOT/ды:MORPH
фрагменті	фрагмент:ROOT/і:MORPH
қандай	қандай:ROOT
шешім	шешім:ROOT
жалғыз	жалғыз:ROOT
өзіне	өз:ROOT/і:MORPH/не:MORPH
саясатпен	саясат:ROOT/пен:MORPH
күмәндіде	күмән:ROOT/ді:MORPH/де:MORPH
қарымқатынас	қарымқатынас:ROOT
үшін	үшін:ROOT
Мерсеннді	Мерсенн:ROOT/ді:MORPH
Егер	Егер:ROOT
қозғалыс	қозғалыс:ROOT
Агафон	Агафон:ROOT
тәсілін	тәсіл:ROOT/і:MORPH/н:MORPH
тар	тар:ROOT
де	де:ROOT
махаббатты	махаббат:ROOT/ты:MORPH
құзырындағы	құзырын:ROOT/да:MORPH/ғы:MORPH
тауып	тау:ROOT/ып:MORPH
Өнерде	Өнер:ROOT/де:MORPH
тән	тән:ROOT
диалектика	диалектика:ROOT
мақсаты	мақсат:ROOT/ы:MORPH
деген	де:ROOT/ген:MORPH
диалог	диалог:ROOT
Сиракузалық	Сиракуза:ROOT/лық:MORPH
Осыдан	Осы:ROOT/дан:MORPH
адамның	адам:ROOT/ның:MORPH
ілімдері	іл:ROOT/ім:MORPH/дер:MORPH/і:MORPH
беретін	бер:ROOT/етін:MORPH
осы	осы:ROOT
оның	о:ROOT/ның:MORPH
бірінен	бір:ROOT/і:MORPH/нен:MORPH
арасындағы	ара:ROOT/сы:MORPH/н:MORPH/дағы:MORPH
десек	де:ROOT/се:MORPH/к:MORPH
Локктың	Локк:ROOT/тың:MORPH
тіпті	тіпті:ROOT
бөлігі	бөліг:ROOT/і:MORPH
шығып	шығ:ROOT/ып:MORPH
болмайтын	бол:ROOT/ма:MORPH/йтын:MORPH
тиеді	ти:ROOT/е:MORPH/ді:MORPH
Локктың	Локк:ROOT/тың:MORPH
оны	о:ROOT/ны:MORPH
екеуінің	еке:ROOT/у:MORPH/і:MORPH/нің:MORPH
мәнінде	мән:ROOT/і:MORPH/н:MORPH/де:MORPH
қосады	қос:ROOT/а:MORPH/ды:MORPH
зерттеуін	зерт:ROOT/те:MORPH/у:MORPH/і:MORPH/н:MORPH
Федр	Федр:ROOT
басқаша	басқа:ROOT/ша:MORPH
туралы	туралы:ROOT
Бұл	Бұл:ROOT
ойын	ой:ROOT/ы:MORPH/н:MORPH
мысалы	мысал:ROOT/ы:MORPH
ойын	ой:ROOT/ы:MORPH/н:MORPH
телігенінен	телі:ROOT/ген:MORPH/і:MORPH/нен:MORPH
Сонымен	Соны:ROOT/мен:MORPH
әсерлі	әсер:ROOT/лі:MORPH
ұзаққа	ұзаққа:ROOT
замандастары	заман:ROOT/дас:MORPH/тар:MORPH/ы:MORPH
Локкты	Локк:ROOT/ты:MORPH
бөлімде	бөлім:ROOT/де:MORPH
пайымдау	пайым:ROOT/да:MORPH/у:MORPH
болмысы	болмыс:ROOT/ы:MORPH
зор	зор:ROOT
екі	екі:ROOT
анықтамалардан	анық:ROOT/тама:MORPH/лар:MORPH/дан:MORPH
түсінеді	түсін:ROOT/е:MORPH/ді:MORPH
Симпозиумдағы	Симпозиум:ROOT/да:MORPH/ғы:MORPH
жақсы	жақсы:ROOT
есептелген	есеп:ROOT/те:MORPH/л:MORPH/ген:MORPH
ортасы	орта:ROOT/сы:MORPH
өрескел	өрес:ROOT/кел:MORPH
философиялық	философия:ROOT/лық:MORPH
қатысты	қатыс:ROOT/ты:MORPH
қолындағы	қол:ROOT/ы:MORPH/н:MORPH/да:MORPH/ғы:MORPH
баяндаған	баян:ROOT/да:MORPH/ған:MORPH
алуан	алуан:ROOT
қалаған	қала:ROOT/ған:MORPH
Екеуінің	Ек:ROOT/еу:MORPH/і:MORPH/нің:MORPH
пыстырарлық	пыс:ROOT/тыр:MORPH/ар:MORPH/лық:MORPH
мына	мына:ROOT
келеді	кел:ROOT/е:MORPH/ді:MORPH
сонымен	со:ROOT/ны:MORPH/мен:MORPH
VI	VI:ROOT
болса	бол:ROOT/са:MORPH
саналатын	сана:ROOT/л:MORPH/атын:MORPH
айналысады	айнал:ROOT/ыс:MORPH/а:MORPH/ды:MORPH
терең	терең:ROOT
түрі	түр:ROOT/і:MORPH
үнемі	үнемі:ROOT
меңгеру	меңгер:ROOT/у:MORPH
болжалсыз	болжал:ROOT/сыз:MORPH
ұсынады	ұсын:ROOT/а:MORPH/ды:MORPH
теңдессіз	теңдес:ROOT/сіз:MORPH
Гоббс	Гоббс:ROOT
тұтпағаны	тұт:ROOT/па:MORPH/ған:MORPH/ы:MORPH
шығармаларға	шығ:ROOT/ар:MORPH/ма:MORPH/лар:MORPH/ға:MORPH
шығады	шығ:ROOT/а:MORPH/ды:MORPH
деп	деп:ROOT
мәнінде	мән:ROOT/і:MORPH/н:MORPH/де:MORPH
арнаға	арна:ROOT/ға:MORPH
сынға	сын:ROOT/ға:MORPH
әртүрлі	әр:ROOT/түр:MORPH/лі:MORPH
орнату	орнат:ROOT/у:MORPH
қолданушы	қол:ROOT/дан:MORPH/у:MORPH/шы:MORPH
бар	бар:ROOT
басының	бас:ROOT/ы:MORPH/ның:MORPH
тең	тең:ROOT
сөз	сөз:ROOT
жазылған	жазыл:ROOT/ған:MORPH
Оның	О:ROOT/ның:MORPH
немесе	немесе:ROOT
Оқырман	Оқыр:ROOT/ман:MORPH
бола	бол:ROOT/а:MORPH
соғыс	соғыс:ROOT
шығады	шығ:ROOT/а:MORPH/ды:MORPH
дегенмен	де:ROOT/ген:MORPH/мен:MORPH
сыни	сын:ROOT/и:MORPH
шешімі	шешім:ROOT/і:MORPH
ант	ант:ROOT
қанша	қанша:ROOT
екеніне	е:ROOT/кен:MORPH/і:MORPH/не:MORPH
толғаныстардан	толғаныс:ROOT/тар:MORPH/дан:MORPH
құрайды	құра:ROOT/й:MORPH/ды:MORPH
сублимацияда	сублимация:ROOT/да:MORPH
XVII	XVII:ROOT
пайымдарымыз	пайым:ROOT/дар:MORPH/ымыз:MORPH
тікелей	тіке:ROOT/лей:MORPH
қарағанда	қара:ROOT/ған:MORPH/да:MORPH
Алайда	Алайда:ROOT
жағынан	жағ:ROOT/ы:MORPH/нан:MORPH
сылдыраған	сылдыр:ROOT/а:MORPH/ған:MORPH
жағдайларға	жағдай:ROOT/лар:MORPH/ға:MORPH
уайымқайғының	уайымқайғы:ROOT/ның:MORPH
үшін	үшін:ROOT
теориясын	теория:ROOT/сы:MORPH/н:MORPH
Сондықтан	Сондықтан:ROOT
мысалдарында	мысал:ROOT/дар:MORPH/ы:MORPH/н:MORPH/да:MORPH
үндестігі	үндес:ROOT/тіг:MORPH/і:MORPH
көрінеді	көрін:ROOT/е:MORPH/ді:MORPH
және	және:ROOT
жартылары	жарты:ROOT/лар:MORPH/ы:MORPH
пайым	пайым:ROOT
не	не:ROOT
айналысады	айнал:ROOT/ыс:MORPH/а:MORPH/ды:MORPH
кез	кез:ROOT
шықпайды	шық:ROOT/па:MORPH/й:MORPH/ды:MORPH
діңгегі	діңге:ROOT/гі:MORPH
махаббатқа	махаббат:ROOT/қа:MORPH
қызу	қызу:ROOT
өмірлік	өмір:ROOT/лік:MORPH
береді	бер:ROOT/е:MORPH/ді:MORPH
ұстанады	ұста:ROOT/н:MORPH/а:MORPH/ды:MORPH
теориясын	теория:ROOT/сы:MORPH/н:MORPH
қатысты	қатысты:ROOT
және	және:ROOT
Локк	Локк:ROOT
айтып	айт:ROOT/ып:MORPH
иесінің	ие:ROOT/сі:MORPH/нің:MORPH
сократтық	сократ:ROOT/тық:MORPH
орны	ор:ROOT/ны:MORPH
замандастарын	заман:ROOT/дас:MORPH/тар:MORPH/ын:MORPH
терминдерді	термин:ROOT/дер:MORPH/ді:MORPH
философ	философ:ROOT
қалап	қала:ROOT/п:MORPH
Сократты	Сократ:ROOT/ты:MORPH
Гоббс	Гоббс:ROOT
туралы	туралы:ROOT
оның	о:ROOT/ның:MORPH
Левиафанның	Левиафан:ROOT/ның:MORPH
мәніне	мән:ROOT/і:MORPH/не:MORPH
Аристотель	Аристотель:ROOT
ұқсастығын	ұқсас:ROOT/тығ:MORPH/ы:MORPH/н:MORPH
лорд	лорд:ROOT
және	және:ROOT
Бірақ	Бірақ:ROOT
бола	бол:ROOT/а:MORPH
бірге	бір:ROOT/ге:MORPH
Заманауи	Заман:ROOT/ау:MORPH/и:MORPH
бірден	бір:ROOT/ден:MORPH
Платонның	Платон:ROOT/ның:MORPH
бұл	бұл:ROOT
сол	сол:ROOT
Лаэрттік	Лаэрт:ROOT/тік:MORPH
бар	бар:ROOT
белгілі	белгі:ROOT/лі:MORPH
сөзді	сөз:ROOT/ді:MORPH
терең	терең:ROOT
пайда	пайда:ROOT
бұрынғы	бұрын:ROOT/ғы:MORPH
Купермен	Купер:ROOT/мен:MORPH
пікірдің	пікір:ROOT/дің:MORPH
Суверен	Суверен:ROOT
Осы	Осы:ROOT
сөзін	сөз:ROOT/ін:MORPH
этиканы	этика:ROOT/ны:MORPH
айырылғанда	айыр:ROOT/ыл:MORPH/ған:MORPH/да:MORPH
қалауынан	қала:ROOT/у:MORPH/ы:MORPH/нан:MORPH
Платон	Платон:ROOT
үшін	үшін:ROOT
танытқанына	таны:ROOT/т:MORPH/қан:MORPH/ы:MORPH/на:MORPH
өзінің	өз:ROOT/і:MORPH/нің:MORPH
түрде	түр:ROOT/де:MORPH
тұжырымдайды	тұжырым:ROOT/да:MORPH/й:MORPH/ды:MORPH
power	power:ROOT
Декарттың	Декарт:ROOT/тың:MORPH
асуының	ас:ROOT/у:MORPH/ы:MORPH/ның:MORPH
мен	мен:ROOT
қатысты	қатыс:ROOT/ты:MORPH
арасында	арас:ROOT/ын:MORPH/да:MORPH
болмаса	бол:ROOT/ма:MORPH/са:MORPH
отырып	отыр:ROOT/ып:MORPH
айтуға	айт:ROOT/у:MORPH/ға:MORPH
айналдырады	айнал:ROOT/дыр:MORPH/а:MORPH/ды:MORPH
қатысты	қатыс:ROOT/ты:MORPH
түсіндіріледі	түсін:ROOT/дір:MORPH/іл:MORPH/е:MORPH/ді:MORPH
Содан	Со:ROOT/дан:MORPH
жүйесінің	жүйе:ROOT/сі:MORPH/нің:MORPH
жылғы	жыл:ROOT/ғы:MORPH
Әңгімеге	Әңгіме:ROOT/ге:MORPH
адамдардың	адам:ROOT/дар:MORPH/дың:MORPH
Аполлодор	Аполлодор:ROOT
кәміл	кәміл:ROOT
төзімді	төз:ROOT/ім:MORPH/ді:MORPH
өзінің	өз:ROOT/і:MORPH/нің:MORPH
топ	топ:ROOT
мылжың	мылжың:ROOT
тұтаса	тұтас:ROOT/а:MORPH
идеяны	идея:ROOT/ны:MORPH
береді	бер:ROOT/е:MORPH/ді:MORPH
бөлінген	бөл:ROOT/ін:MORPH/ген:MORPH
Амстердамда	Амстердам:ROOT/да:MORPH
ақылойдың	ақылой:ROOT/дың:MORPH
қалған	қал:ROOT/ған:MORPH
сөз	сөз:ROOT
жерден	жер:ROOT/ден:MORPH
өзінің	өз:ROOT/і:MORPH/нің:MORPH
Осы	Осы:ROOT
көзқарастарды	көз:ROOT/қара:MORPH/с:MORPH/тар:MORPH/ды:MORPH
тұрмауы	тұр:ROOT/ма:MORPH/у:MORPH/ы:MORPH
әр	әр:ROOT
қазынасы	қазына:ROOT/сы:MORPH
мұратынан	мұрат:ROOT/ы:MORPH/нан:MORPH
Кедейлік	Кедей:ROOT/лік:MORPH
десек	де:ROOT/се:MORPH/к:MORPH
екенін	е:ROOT/кен:MORPH/і:MORPH/н:MORPH
кіргізіп	кір:ROOT/гіз:MORPH/іп:MORPH
Өкінішке	Өкініш:ROOT/ке:MORPH
батырды	батыр:ROOT/ды:MORPH
Декарт	Декарт:ROOT
жөніндегі	жөн:ROOT/і:MORPH/н:MORPH/де:MORPH/гі:MORPH
әкетеді	әкет:ROOT/е:MORPH/ді:MORPH
әрқилы	әрқилы:ROOT
жөн	жөн:ROOT
Шарт	Шарт:ROOT
іспеттес	іспет:ROOT/тес:MORPH
өзіндеақ	өзін:ROOT/деақ:MORPH
ашады	аш:ROOT/а:MORPH/ды:MORPH
деп	де:ROOT/п:MORPH
жоқ	жоқ:ROOT
Бұл	Бұл:ROOT
пікірталастағы	пікір:ROOT/талас:MORPH/та:MORPH/ғы:MORPH
ғылымның	ғылым:ROOT/ның:MORPH
саяхатқа	саяхат:ROOT/қа:MORPH
Осы	Осы:ROOT
Мінәжаттың	Мінәжат:ROOT/тың:MORPH
күрес	күрес:ROOT
болжалдың	болжал:ROOT/дың:MORPH
атпен	ат:ROOT/пен:MORPH
ғылымға	ғылым:ROOT/ға:MORPH
тіршілік	тір:ROOT/шілік:MORPH
шауып	ша:ROOT/у:MORPH/ып:MORPH
Сократпен	Сократ:ROOT/пен:MORPH
Алайда	Алайда:ROOT
пікірталас	пікір:ROOT/талас:MORPH
үлгісі	үлгі:ROOT/сі:MORPH
ахуал	ахуал:ROOT
баламасы	балама:ROOT/сы:MORPH
ашуға	аш:ROOT/у:MORPH/ға:MORPH
қолданады	қол:ROOT/дан:MORPH/а:MORPH/ды:MORPH
басқа	басқа:ROOT
ақиқатты	ақиқат:ROOT/ты:MORPH
Шатле	Шатле:ROOT
алады	ал:ROOT/а:MORPH/ды:MORPH
Эриксимахты	Эриксимах:ROOT/ты:MORPH
тынымсыз	тыным:ROOT/сыз:MORPH
өсу	өс:ROOT/у:MORPH
пен	пен:ROOT
емес	е:ROOT/мес:MORPH
мифке	миф:ROOT/ке:MORPH
Шындығында	Шын:ROOT/дығ:MORPH/ы:MORPH/н:MORPH/да:MORPH
арасындағы	ара:ROOT/сы:MORPH/н:MORPH/да:MORPH/ғы:MORPH
жаратылыс	жарат:ROOT/ыл:MORPH/ыс:MORPH
қатар	қатар:ROOT
Сократ	Сократ:ROOT
түсетін	түс:ROOT/етін:MORPH
қабілеті	қабілет:ROOT/і:MORPH
бір	бір:ROOT
яғни	яғни:ROOT
оның	о:ROOT/ның:MORPH
әтектікке	әтек:ROOT/тік:MORPH/ке:MORPH
Симпозиум	Симпозиум:ROOT
болмысында	бол:ROOT/мыс:MORPH/ы:MORPH/н:MORPH/да:MORPH
әзелгі	әзел:ROOT/гі:MORPH
Азаматтық	Азамат:ROOT/тық:MORPH
дөрекі	дөре:ROOT/кі:MORPH
бойында	бой:ROOT/ы:MORPH/н:MORPH/да:MORPH
адам	адам:ROOT
тұжырымдайды	тұжырым:ROOT/да:MORPH/й:MORPH/ды:MORPH
Лейбниц	Лейбниц:ROOT
тақырыпты	тақырып:ROOT/ты:MORPH
дүниеге	дүние:ROOT/ге:MORPH
кездеседі	кездес:ROOT/е:MORPH/ді:MORPH
Оның	О:ROOT/ның:MORPH
барлық	барлық:ROOT
шөліркеуіне	шөліркеу:ROOT/і:MORPH/не:MORPH
ауылына	ауыл:ROOT/ы:MORPH/на:MORPH
сүйіспеншілікке	сүй:ROOT/іс:MORPH/пен:MORPH/шілік:MORPH/ке:MORPH
қарамақайшылықтарды	қарамақайшы:ROOT/лық:MORPH/тар:MORPH/ды:MORPH
идеялар	идея:ROOT/лар:MORPH
ізбасарымын	ізбасар:ROOT/ы:MORPH/мын:MORPH
дейін	дейін:ROOT
естуге	есту:ROOT/ге:MORPH
жазды	жаз:ROOT/ды:MORPH
қарекет	қарекет:ROOT
қағазға	қағаз:ROOT/ға:MORPH
диалогтары	диалог:ROOT/тар:MORPH/ы:MORPH
тәжірибелік	тәжірибе:ROOT/лік:MORPH
Ұлы	Ұлы:ROOT
де	де:ROOT
алайда	алайда:ROOT
Әңгімеге	Әңгіме:ROOT/ге:MORPH
жаны	жан:ROOT/ы:MORPH
кейбір	кейбір:ROOT
бөлім	бөл:ROOT/ім:MORPH
сұлу	сұлу:ROOT
Дегенмен	Де:ROOT/ген:MORPH/мен:MORPH
отырып	отыр:ROOT/ып:MORPH
идеялар	идея:ROOT/лар:MORPH
аяқтағаннан	аяқ:ROOT/та:MORPH/ған:MORPH/нан:MORPH
мәнін	мән:ROOT/і:MORPH/н:MORPH
және	және:ROOT
оны	о:ROOT/ны:MORPH
және	және:ROOT
туабітті	туабіт:ROOT/ті:MORPH
үшін	үшін:ROOT
тұрғысынан	тұрғыс:ROOT/ы:MORPH/нан:MORPH
Федоннан	Федон:ROOT/нан:MORPH
ұшырайтын	ұш:ROOT/ыра:MORPH/йтын:MORPH
жан	жан:ROOT
ұқсастығын	ұқсас:ROOT/тығ:MORPH/ы:MORPH/н:MORPH
өзгертуді	өзгер:ROOT/т:MORPH/у:MORPH/ді:MORPH
түскен	түс:ROOT/кен:MORPH
Декарттың	Декарт:ROOT/тың:MORPH
адамның	адам:ROOT/ның:MORPH
бірге	бір:ROOT/ге:MORPH
алмайтын	ал:ROOT/ма:MORPH/йтын:MORPH
талқылауға	талқы:ROOT/ла:MORPH/у:MORPH/ға:MORPH
босандырып	босан:ROOT/дыр:MORPH/ып:MORPH
әйеліне	әйел:ROOT/і:MORPH/не:MORPH
пайымдалса	пайым:ROOT/да:MORPH/л:MORPH/са:MORPH
еді	е:ROOT/ді:MORPH
біздің	біз:ROOT/дің:MORPH
барлық	бар:ROOT/лық:MORPH
түшкіруді	түшкір:ROOT/у:MORPH/ді:MORPH
арқылы	арқылы:ROOT
жетудің	жет:ROOT/у:MORPH/дің:MORPH
тұрғысынан	тұрғы:ROOT/сы:MORPH/нан:MORPH
қойысымен	қой:ROOT/ы:MORPH/сы:MORPH/мен:MORPH
заңмен	заң:ROOT/мен:MORPH
жоғары	жоғары:ROOT
Диалог	Диалог:ROOT
ғашықтық	ғашық:ROOT/тық:MORPH
пікірталасқа	пікір:ROOT/талас:MORPH/қа:MORPH
бұл	бұл:ROOT
мағынасына	мағына:ROOT/сы:MORPH/на:MORPH
Табиғи	Табиғ:ROOT/и:MORPH
қақтығысы	қақтығыс:ROOT/ы:MORPH
һәм	һәм:ROOT
Құдай	Құдай:ROOT
тас	тас:ROOT
тұр	тұр:ROOT
түсіндірумен	түсін:ROOT/дір:MORPH/у:MORPH/мен:MORPH
салыстырғанда	салыс:ROOT/тыр:MORPH/ған:MORPH/да:MORPH
мысалы	мысалы:ROOT
сұраққа	сұрақ:ROOT/қа:MORPH
шықты	шық:ROOT/ты:MORPH
билік	би:ROOT/лік:MORPH
бір	бір:ROOT
соң	соң:ROOT
қарапайым	қарапайым:ROOT
шығармашылығындағы	шығ:ROOT/ар:MORPH/ма:MORPH/шылығ:MORPH/ы:MORPH/н:MORPH/да:MORPH/ғы:MORPH
айтуын	айт:ROOT/у:MORPH/ы:MORPH/н:MORPH
мемлекеттің	мемлекет:ROOT/тің:MORPH
бермейді	бер:ROOT/ме:MORPH/й:MORPH/ді:MORPH
назарын	назар:ROOT/ы:MORPH/н:MORPH
Зевстің	Зевс:ROOT/тің:MORPH
шығарманың	шығ:ROOT/ар:MORPH/ма:MORPH/ның:MORPH
Шындығында	Шын:ROOT/дығ:MORPH/ы:MORPH/н:MORPH/да:MORPH
орынсыз	орын:ROOT/сыз:MORPH
сөз	сөз:ROOT
мен	мен:ROOT
ескерткеніндей	ескер:ROOT/т:MORPH/кен:MORPH/і:MORPH/н:MORPH/дей:MORPH
ортақ	ортақ:ROOT
себептері	себеп:ROOT/тер:MORPH/і:MORPH
оның	о:ROOT/ның:MORPH
жарықтың	жарық:ROOT/тың:MORPH
бар	бар:ROOT
талпынған	талп:ROOT/ын:MORPH/ған:MORPH
пен	пен:ROOT
болмысын	бол:ROOT/мыс:MORPH/ын:MORPH
ұғуға	ұғ:ROOT/у:MORPH/ға:MORPH
дейін	дейін:ROOT
бірыңғай	бір:ROOT/ың:MORPH/ғай:MORPH
философ	философ:ROOT
да	да:ROOT
қоғамдық	қоғамдық:ROOT
айналдыра	айнал:ROOT/дыр:MORPH/а:MORPH
алдын	алдын:ROOT
қарсы	қарсы:ROOT
шықпай	шық:ROOT/па:MORPH/й:MORPH
міндетті	міндет:ROOT/ті:MORPH
пен	пен:ROOT
Сырқатынан	Сырқат:ROOT/ы:MORPH/нан:MORPH
шешкен	шеш:ROOT/кен:MORPH
тәсілі	тәсілі:ROOT
әңгімелейді	әңгімеле:ROOT/й:MORPH/ді:MORPH
қисық	қисық:ROOT
тағы	тағы:ROOT
жылға	жыл:ROOT/ға:MORPH
Санадағы	Сана:ROOT/да:MORPH/ғы:MORPH
ол	ол:ROOT
жайындағы	жай:ROOT/ы:MORPH/н:MORPH/да:MORPH/ғы:MORPH
күрделі	күрделі:ROOT
түсінетін	түс:ROOT/ін:MORPH/етін:MORPH
Өйткені	Өйткені:ROOT
ауру	ауру:ROOT
Геометрияда	Геометрия:ROOT/да:MORPH
тереңірек	терең:ROOT/ірек:MORPH
нақты	нақты:ROOT
қалыптастыруға	қалыптастыр:ROOT/у:MORPH/ға:MORPH
Оның	О:ROOT/ның:MORPH
хатхабар	хатхабар:ROOT
іс	іс:ROOT
шын	шын:ROOT
шығармасының	шығ:ROOT/ар:MORPH/ма:MORPH/сы:MORPH/ның:MORPH
табиғаттың	табиғат:ROOT/тың:MORPH
қандай	қандай:ROOT
Музыка	Музыка:ROOT
деген	де:ROOT/ген:MORPH
Марен	Марен:ROOT
осы	осы:ROOT
әдебиетінен	әдебиет:ROOT/і:MORPH/нен:MORPH
аяғы	аяғ:ROOT/ы:MORPH
келіскеннен	келіс:ROOT/кен:MORPH/нен:MORPH
жеріне	жер:ROOT/і:MORPH/не:MORPH
аударылған	аудар:ROOT/ыл:MORPH/ған:MORPH
символдық	символ:ROOT/дық:MORPH
әңгімелейді	әңгіме:ROOT/ле:MORPH/й:MORPH/ді:MORPH
теориялық	теория:ROOT/лық:MORPH
деп	де:ROOT/п:MORPH
мақтан	мақта:ROOT/н:MORPH
дегенмен	дегенмен:ROOT
бар	бар:ROOT
идеялар	идея:ROOT/лар:MORPH
мүмкін	мүмкін:ROOT
шығармасының	шығ:ROOT/ар:MORPH/ма:MORPH/сы:MORPH/ның:MORPH
Заңдар	Заңдар:ROOT
қарамастан	қара:ROOT/мас:MORPH/тан:MORPH
теориялық	теория:ROOT/лық:MORPH
өз	өз:ROOT
жүйенің	жүйе:ROOT/нің:MORPH
Әділдіктің	Әділ:ROOT/дік:MORPH/тің:MORPH
парасаттылық	парасат:ROOT/ты:MORPH/лық:MORPH
жердің	жер:ROOT/дің:MORPH
байланысты	байла:ROOT/ныс:MORPH/ты:MORPH
қуаттайтын	қуат:ROOT/та:MORPH/йтын:MORPH
түсіндіруінше	түсін:ROOT/дір:MORPH/у:MORPH/і:MORPH/н:MORPH/ше:MORPH
әділдікке	әділ:ROOT/дік:MORPH/ке:MORPH
әрі	әрі:ROOT
жеткізу	жет:ROOT/кіз:MORPH/у:MORPH
араласып	ара:ROOT/лас:MORPH/ып:MORPH
сезімдер	сезім:ROOT/дер:MORPH
оқымысты	оқы:ROOT/мысты:MORPH
оны	о:ROOT/ны:MORPH
қызықты	қызық:ROOT/ты:MORPH
оны	о:ROOT/ны:MORPH
емес	е:ROOT/мес:MORPH
ретінде	ретін:ROOT/де:MORPH
махаббаттың	махаббат:ROOT/тың:MORPH
шақырады	шақыр:ROOT/а:MORPH/ды:MORPH
жоққа	жоқ:ROOT/қа:MORPH
өз	өз:ROOT
Локктың	Локк:ROOT/тың:MORPH
сыртқы	сырт:ROOT/қы:MORPH
емес	е:ROOT/мес:MORPH
диалектика	диалектика:ROOT
да	да:ROOT
Ф	Ф:ROOT
шағындағы	шағ:ROOT/ын:MORPH/да:MORPH/ғы:MORPH
тамыр	тамыр:ROOT
ұнатуының	ұнат:ROOT/у:MORPH/ы:MORPH/ның:MORPH
арнайы	арнай:ROOT/ы:MORPH
ғана	ғана:ROOT
да	да:ROOT
Платон	Платон:ROOT
тұжырымдалған	тұжырым:ROOT/да:MORPH/л:MORPH/ған:MORPH
келе	кел:ROOT/е:MORPH
жалғыз	жалғыз:ROOT
диалог	диалог:ROOT
Аристофанның	Аристофан:ROOT/ның:MORPH
армандарымен	арман:ROOT/дар:MORPH/ы:MORPH/мен:MORPH
ал	ал:ROOT
тұрғысынан	тұрғы:ROOT/сы:MORPH/нан:MORPH
қасаң	қасаң:ROOT
бірегейлігін	бірегей:ROOT/ліг:MORPH/і:MORPH/н:MORPH
айдан	ай:ROOT/дан:MORPH
талас	талас:ROOT
және	және:ROOT
яғни	яғни:ROOT
Гоббс	Гоббс:ROOT
Адам	Адам:ROOT
болып	бол:ROOT/ып:MORPH
Поростың	Порос:ROOT/тың:MORPH
қолына	қол:ROOT/ы:MORPH/на:MORPH
Алкивиад	Алкивиад:ROOT
Ал	Ал:ROOT
Аугустиннен	Аугустин:ROOT/нен:MORPH
жағдайлар	жағдай:ROOT/лар:MORPH
айтады	айт:ROOT/а:MORPH/ды:MORPH
картезиандықтармен	картезиан:ROOT/дық:MORPH/тар:MORPH/мен:MORPH
ғана	ғана:ROOT
қажеті	қажеті:ROOT
Адам	Адам:ROOT
айырмашылығы	айыр:ROOT/ма:MORPH/шылығ:MORPH/ы:MORPH
дәрістеріне	дәріс:ROOT/тер:MORPH/і:MORPH/не:MORPH
тұлға	тұл:ROOT/ға:MORPH
Кейін	Кейін:ROOT
білуді	біл:ROOT/у:MORPH/ді:MORPH
пен	пен:ROOT
сұхбаттасушылар	сұхбат:ROOT/тас:MORPH/у:MORPH/шы:MORPH/лар:MORPH
Симпозиумдағы	Симпозиум:ROOT/да:MORPH/ғы:MORPH
жоқ	жоқ:ROOT
кез	кез:ROOT
өзгелер	өз:ROOT/ге:MORPH/лер:MORPH
көп	көп:ROOT
осындай	осы:ROOT/нда:MORPH/й:MORPH
бұл	бұл:ROOT
Оның	О:ROOT/ның:MORPH
әйелдерді	әйел:ROOT/дер:MORPH/ді:MORPH
кесуге	кесу:ROOT/ге:MORPH
Гераклдің	Геракл:ROOT/дің:MORPH
айта	айт:ROOT/а:MORPH
құрсауынан	құрсау:ROOT/ы:MORPH/нан:MORPH
өз	өз:ROOT
болу	бол:ROOT/у:MORPH
жатқаны	жат:ROOT/қан:MORPH/ы:MORPH
ойын	ой:ROOT/ы:MORPH/н:MORPH
махаббаттың	махаббат:ROOT/тың:MORPH
сүрген	сүр:ROOT/ген:MORPH
Ал	Ал:ROOT
кезегін	кезег:ROOT/ін:MORPH
санайды	сана:ROOT/й:MORPH/ды:MORPH
принциптерге	принцип:ROOT/тер:MORPH/ге:MORPH
ғана	ғана:ROOT
өзі	өз:ROOT/і:MORPH
шарықтау	шарық:ROOT/та:MORPH/у:MORPH
тағдыры	тағдыр:ROOT/ы:MORPH
білімді	білім:ROOT/ді:MORPH
жаңа	жаңа:ROOT
сүйене	сүйен:ROOT/е:MORPH
Демек	Де:ROOT/ме:MORPH/к:MORPH
тағы	тағы:ROOT
ойға	ой:ROOT/ға:MORPH
Оның	Оның:ROOT
астарында	астар:ROOT/ы:MORPH/н:MORPH/да:MORPH
сәбилердің	сәби:ROOT/лер:MORPH/дің:MORPH
айлакер	айла:ROOT/кер:MORPH
пікірталас	пікір:ROOT/талас:MORPH
қажет	қажет:ROOT
қарамағына	қарамағ:ROOT/ы:MORPH/на:MORPH
туғызу	ту:ROOT/ғыз:MORPH/у:MORPH
қысқаша	қысқаша:ROOT
әлсіреуі	әлсіре:ROOT/у:MORPH/і:MORPH
сыни	сын:ROOT/и:MORPH
жеткізу	жет:ROOT/кіз:MORPH/у:MORPH
замандарда	заман:ROOT/дар:MORPH/да:MORPH
тарихындағы	тарих:ROOT/ы:MORPH/н:MORPH/да:MORPH/ғы:MORPH
күші	күш:ROOT/і:MORPH
кететін	кет:ROOT/етін:MORPH
әлдебір	әлде:ROOT/бір:MORPH
өз	өз:ROOT
заңдылық	заң:ROOT/ды:MORPH/лық:MORPH
Метеорларда	Метеор:ROOT/лар:MORPH/да:MORPH
беремін	бер:ROOT/е:MORPH/мін:MORPH
тұрған	тұр:ROOT/ған:MORPH
зор	зор:ROOT
Декарттың	Декарт:ROOT/тың:MORPH
ажыратуға	ажырат:ROOT/у:MORPH/ға:MORPH
құбылыс	құбылыс:ROOT
